,Signal_Upper,coverage_naive,coverage_split50,coverage_split67,coverage_posi,length_naive,length_split50,length_split67,length_posi,nnz_naive,nnz_split50,nnz_split67,nnz_posi,tp_naive,tp_split50,tp_split67,tp_posi,tn_naive,tn_split50,tn_split67,tn_posi,fp_naive,fp_split50,fp_split67,fp_posi,fn_naive,fn_split50,fn_split67,fn_posi
0,0.1,0.5714285714285714,0.8333333333333334,0.42857142857142855,0.9130434782608695,3.6078650833016885,5.487657936476664,6.931863879659076,3.993001999433558,7,18,7,46,0,0,0,5,81,70,81,47,7,18,7,41,12,12,12,7
1,0.1,0.8,0.8421052631578947,0.8333333333333334,0.9310344827586207,3.6994704451368605,5.542340172924831,6.603974964905916,3.816556459449201,15,19,24,29,5,5,9,5,78,74,73,64,10,14,15,24,7,7,3,7
2,0.1,0.8,0.9583333333333334,0.85,1.0,3.6503712009588196,5.124236138520831,6.476608549268633,3.9482254759097297,15,24,20,23,5,5,5,5,78,69,73,70,10,19,15,18,7,7,7,7
3,0.1,0.7692307692307693,1.0,0.8571428571428571,0.9117647058823529,3.6150064565358377,5.51046100164989,6.890557026168313,3.921988918948202,13,18,21,34,0,4,0,0,75,74,67,54,13,14,21,34,12,8,12,12
4,0.1,0.8888888888888888,1.0,0.7777777777777778,0.875,3.7509061913861035,5.25691836983376,6.488427611743799,4.2215613007067985,9,4,9,24,0,0,0,0,79,84,79,64,9,4,9,24,12,12,12,12
5,0.1,0.7647058823529411,0.9318181818181818,1.0,0.9,3.841053781144442,6.178265155362308,7.442062181405383,4.40581860981182,17,44,5,10,12,5,0,7,83,49,83,85,5,39,5,3,0,7,12,5
6,0.1,0.7857142857142857,0.9166666666666666,0.8,0.8571428571428571,3.710759462478393,5.695200601614193,6.570411974507062,4.090063923795982,14,24,5,14,9,9,5,9,83,73,88,83,5,15,0,5,3,3,7,3
7,0.1,0.8275862068965517,0.8947368421052632,0.7142857142857143,0.9285714285714286,3.657234612259622,4.8708912240156925,6.473553862831936,3.768589644044794,29,19,14,14,5,5,5,5,64,74,79,79,24,14,9,9,7,7,7,7
8,0.1,0.7368421052631579,0.9444444444444444,0.75,0.9047619047619048,3.5582254177728734,5.12873254088261,7.180452475166869,3.8093352245965697,19,18,4,21,4,3,4,7,73,73,88,74,15,15,0,14,8,9,8,5
9,0.1,0.5,0.7142857142857143,0.8181818181818182,0.875,3.7761976290778163,5.384405666346258,6.330983395298981,4.310822104397273,4,7,11,8,4,0,4,4,88,81,81,84,0,7,7,4,8,12,8,8
10,0.1,0.9,1.0,1.0,0.8928571428571429,3.6683231066649684,5.332775847168327,6.280016225738586,4.1048788425978096,10,10,4,28,5,0,4,9,83,78,88,69,5,10,0,19,7,12,8,3
11,0.1,,0.8888888888888888,,0.8787878787878788,,5.224321849570204,,3.9385720451482364,0,9,0,33,0,9,0,3,88,88,88,58,0,0,0,30,12,3,12,9
12,0.1,0.88,0.9512195121951219,0.8947368421052632,0.9523809523809523,3.7231799420183984,5.75634993181844,7.034923385996074,3.962973081805869,25,41,19,42,8,9,0,5,71,56,69,51,17,32,19,37,4,3,12,7
13,0.1,0.8333333333333334,0.85,1.0,1.0,3.735216151734494,5.640951328862797,7.952135661313268,3.9896465185760035,18,20,35,33,0,4,3,4,70,72,56,59,18,16,32,29,12,8,9,8
14,0.1,0.75,0.8387096774193549,0.9090909090909091,0.84,3.694437232851219,5.459328286961516,7.453452265901885,4.039587758154659,8,31,22,25,0,0,0,0,80,57,66,63,8,31,22,25,12,12,12,12
15,0.1,0.8333333333333334,0.85,0.9473684210526315,0.8611111111111112,3.689975753221263,5.716804938628318,6.348771912391944,3.9283378432011364,12,20,19,36,5,0,5,0,81,68,74,52,7,20,14,36,7,12,7,12
16,0.1,1.0,0.8421052631578947,0.9,0.875,3.768720148321824,5.466013033976553,6.815654932870812,4.2488490043948985,3,19,10,40,0,4,0,9,85,73,78,57,3,15,10,31,12,8,12,3
17,0.1,0.4,0.9333333333333333,1.0,0.9230769230769231,3.6424385979991336,5.074147545025203,6.782918818347342,3.948769005054785,5,15,4,13,0,0,0,0,83,73,84,75,5,15,4,13,12,12,12,12
18,0.1,0.9,0.8947368421052632,0.8,0.95,3.6308679234263495,5.922889782552596,6.81025245534089,3.76722397356255,10,38,10,20,0,5,0,0,78,55,78,68,10,33,10,20,12,7,12,12
19,0.1,1.0,0.9,0.8666666666666667,1.0,3.6309599164274164,5.472497641921913,6.612561886829716,3.8245545883938235,13,20,15,23,5,0,8,5,80,68,81,70,8,20,7,18,7,12,4,7
20,0.1,0.7,1.0,0.9333333333333333,0.9393939393939394,3.485820490233448,5.048171733495107,5.903814366905211,3.6906985584513525,10,11,15,33,0,3,0,8,78,80,73,63,10,8,15,25,12,9,12,4
21,0.1,0.3333333333333333,1.0,1.0,0.8214285714285714,3.618423552615988,5.501935761103194,6.352533687036948,4.022710431700107,3,3,3,28,3,3,3,8,88,88,88,68,0,0,0,20,9,9,9,4
22,0.1,0.8064516129032258,0.8333333333333334,0.9259259259259259,0.8260869565217391,3.719531048895017,5.364291508110053,7.095056918839816,3.739631503627916,31,24,54,46,5,8,8,8,62,72,42,50,26,16,46,38,7,4,4,4
23,0.1,0.8,0.8666666666666667,1.0,1.0,3.8037798021358875,5.511181607063474,6.733410206364009,4.16848543322562,5,15,5,23,5,5,0,0,88,78,83,65,0,10,5,23,7,7,12,12
24,0.1,0.8,1.0,0.8,1.0,3.7216873624942677,5.174444713266243,6.949931668531639,4.184186577014956,5,8,30,27,0,5,5,0,83,85,63,61,5,3,25,27,12,7,7,12
25,0.1,1.0,0.96,0.9333333333333333,0.9310344827586207,3.730618224524044,5.713604185006558,6.608323033957527,3.975831737398462,15,25,15,29,5,9,5,5,78,72,78,64,10,16,10,24,7,3,7,7
26,0.1,0.6666666666666666,0.75,1.0,0.96,3.744073411547777,5.081579811606396,7.181952008537034,4.143625254292812,3,4,7,25,0,0,0,3,85,84,81,66,3,4,7,22,12,12,12,9
27,0.1,0.84375,0.9473684210526315,0.9130434782608695,0.9038461538461539,3.606496297314552,5.35554250739857,6.905160852541631,3.746602134779898,32,38,23,52,5,0,5,5,61,50,70,41,27,38,18,47,7,12,7,7
28,0.1,,0.9444444444444444,1.0,1.0,,5.790938046061759,5.84245559777888,4.1653174260354024,0,36,6,17,0,12,3,3,88,64,85,74,0,24,3,14,12,0,9,9
29,0.1,0.8,0.8823529411764706,1.0,1.0,3.52484109779211,5.993250564389423,6.2778226568061815,3.9778668744787415,5,34,5,9,5,0,5,5,88,54,88,84,0,34,0,4,7,12,7,7
30,0.1,0.9,0.9,0.96,1.0,3.5542632969898067,5.438136953568101,7.222200942929889,3.9481349450458185,10,20,25,25,5,5,5,5,83,73,68,68,5,15,20,20,7,7,7,7
31,0.1,0.6666666666666666,0.8421052631578947,0.8888888888888888,0.8076923076923077,3.6965139580026403,5.418866631291484,6.930429076378519,3.9213469664692777,18,19,18,26,3,4,3,7,73,73,73,69,15,15,15,19,9,8,9,5
32,0.1,0.7083333333333334,0.9130434782608695,0.9545454545454546,0.8627450980392157,3.7832405196741266,5.480442127669803,6.83953267010824,3.8792583285377837,24,46,22,51,4,9,0,9,68,51,66,46,20,37,22,42,8,3,12,3
33,0.1,0.75,1.0,0.875,0.96,3.537493470649984,5.44504088738332,6.204010923828216,4.000551096800539,8,22,8,25,8,8,8,8,88,74,88,71,0,14,0,17,4,4,4,4
34,0.1,0.7368421052631579,0.8125,0.8,0.6666666666666666,3.5735171759683677,5.337095541349983,6.694427001600038,3.8685225522488955,19,16,15,24,0,0,0,9,69,72,73,73,19,16,15,15,12,12,12,3
35,0.1,0.7857142857142857,0.8809523809523809,0.8461538461538461,0.8636363636363636,3.7299977392585384,5.841813215780261,6.810654420290986,4.0715323613871774,14,42,13,22,4,4,0,9,78,50,75,75,10,38,13,13,8,8,12,3
36,0.1,0.6666666666666666,0.9302325581395349,1.0,0.9285714285714286,3.685367513039832,5.7931157671091045,6.525653156333277,3.8297510157028016,3,43,3,28,3,3,3,3,88,48,88,63,0,40,0,25,9,9,9,9
37,0.1,0.7777777777777778,0.9433962264150944,0.8571428571428571,1.0,3.7260396183189397,6.043905470137233,6.684663227472301,4.014846106468477,18,53,14,24,4,7,4,0,74,42,78,64,14,46,10,24,8,5,8,12
38,0.1,0.5,0.9166666666666666,0.8148148148148148,0.8333333333333334,3.6269040786248956,5.116827334841068,6.953388328323706,3.6910068988607683,10,12,27,24,5,4,5,5,83,80,66,69,5,8,22,19,7,8,7,7
39,0.1,,0.9,0.85,0.9333333333333333,,6.029680054698291,6.996250926105804,4.382408979319064,0,30,20,15,0,0,0,0,88,58,68,73,0,30,20,15,12,12,12,12
40,0.1,1.0,0.8333333333333334,1.0,0.8888888888888888,3.6036053558511387,5.29646132254002,6.078353786849264,4.1669613975217805,4,18,7,18,0,5,0,0,84,75,81,70,4,13,7,18,12,7,12,12
41,0.1,0.8,0.8571428571428571,0.8,0.9642857142857143,3.7254659523624256,5.703748025706462,6.304891892690364,3.901162447716811,5,42,10,28,5,5,0,5,88,51,78,65,0,37,10,23,7,7,12,7
42,0.1,0.8,0.9047619047619048,0.875,1.0,3.7614448606959856,5.4150783154911,6.402308120637724,4.019858957669189,5,21,24,9,0,3,0,0,83,70,64,79,5,18,24,9,12,9,12,12
43,0.1,0.6153846153846154,0.8823529411764706,0.9333333333333333,0.9210526315789473,3.7037813589433863,5.7078111729966725,7.080973176655135,3.937928510638949,13,34,15,38,4,4,0,4,79,58,73,54,9,30,15,34,8,8,12,8
44,0.1,0.7333333333333333,0.918918918918919,0.7222222222222222,0.8297872340425532,3.734921495518284,5.897258066084217,6.85916661540667,4.029337574530554,15,37,18,47,0,0,0,5,73,51,70,46,15,37,18,42,12,12,12,7
45,0.1,0.7857142857142857,0.8,1.0,0.9302325581395349,3.9538331478852444,5.728730116876234,6.992350163241172,4.308357737743535,14,25,4,43,0,0,0,0,74,63,84,45,14,25,4,43,12,12,12,12
46,0.1,0.8,0.9285714285714286,0.9,0.9130434782608695,3.82712718577982,5.509827302194293,7.060063751867607,4.165297427680362,10,14,10,23,0,0,0,8,78,74,78,73,10,14,10,15,12,12,12,4
47,0.1,1.0,0.9473684210526315,0.9,0.9482758620689655,3.678467429322608,5.489496323084421,6.5225979986600136,3.910638714475798,4,19,10,58,4,4,5,4,88,73,83,34,0,15,5,54,8,8,7,8
48,0.1,,1.0,0.8,1.0,,5.068088665365369,6.2043225173898,4.188114894644397,0,10,5,13,0,5,5,0,88,83,88,75,0,5,0,13,12,7,7,12
49,0.1,0.8,0.9354838709677419,,0.9473684210526315,3.783972979992837,5.460108939928552,,3.983020772534936,15,31,0,19,5,12,0,0,78,69,88,69,10,19,0,19,7,0,12,12
50,0.1,0.8666666666666667,1.0,1.0,0.8695652173913043,3.727130535989631,5.421463742305744,7.91303693079772,4.1060947077973085,15,12,24,23,0,0,4,0,73,76,68,65,15,12,20,23,12,12,8,12
51,0.1,0.7333333333333333,0.9166666666666666,0.7647058823529411,0.8723404255319149,3.817771805671065,5.413677204847403,7.011375177771177,3.985048002166138,15,12,17,47,5,4,5,9,78,80,76,50,10,8,12,38,7,8,7,3
52,0.1,0.8,0.8703703703703703,0.9142857142857143,0.875,3.738502677891993,5.932835127331811,6.882599008425191,3.8134158982667397,25,54,35,48,5,8,5,5,68,42,58,45,20,46,30,43,7,4,7,7
53,0.1,0.8,0.8947368421052632,1.0,1.0,3.606219728150356,5.175322767101176,6.642373595242855,4.03377671934124,5,19,9,9,0,4,4,0,83,73,83,79,5,15,5,9,12,8,8,12
54,0.1,0.7777777777777778,0.8333333333333334,0.9,0.75,3.649654913221732,5.306339986100286,7.179626941284615,3.902553824290616,9,12,10,20,5,5,5,5,84,81,83,73,4,7,5,15,7,7,7,7
55,0.1,0.6,0.7142857142857143,0.9411764705882353,0.90625,3.628832978921371,5.319962904266258,7.033191118371966,3.949620242105202,10,14,17,32,0,0,4,7,78,74,75,63,10,14,13,25,12,12,8,5
56,0.1,,0.9130434782608695,1.0,1.0,,5.963568319946855,6.74937816560105,4.525393642160984,0,23,4,21,0,3,0,0,88,68,84,67,0,20,4,21,12,9,12,12
57,0.1,0.7222222222222222,0.9523809523809523,0.8636363636363636,0.875,3.5259118530965545,4.984183129899882,6.33563642044156,3.808025346925901,18,21,22,32,0,12,0,7,70,79,66,63,18,9,22,25,12,0,12,5
58,0.1,0.9166666666666666,0.8974358974358975,0.8571428571428571,0.9310344827586207,3.471084877073944,5.585333630709034,6.1337441803858,3.6250533525403785,24,39,28,29,9,9,9,4,73,58,69,63,15,30,19,25,3,3,3,8
59,0.1,0.8,0.875,0.9166666666666666,0.9655172413793104,3.5822603726180495,5.569768152900093,6.735516209264404,3.9211894952216544,5,40,12,29,0,3,3,0,83,51,79,59,5,37,9,29,12,9,9,12
60,0.1,0.9,0.8529411764705882,1.0,0.9117647058823529,3.469012565114421,5.240162590858096,6.8944782847153165,3.6251657723681134,10,34,9,34,5,9,5,5,83,63,84,59,5,25,4,29,7,3,7,7
61,0.1,0.8333333333333334,0.8823529411764706,1.0,0.9285714285714286,3.6888393734467244,5.232566082387127,7.033571658469507,4.092790741132494,6,17,9,14,0,7,3,8,82,78,82,82,6,10,6,6,12,5,9,4
62,0.1,0.6666666666666666,0.75,1.0,0.9333333333333333,3.724036432638176,5.953582024683887,7.291760776243799,4.418460905230961,3,12,8,15,0,4,5,7,85,80,85,80,3,8,3,8,12,8,7,5
63,0.1,0.8125,1.0,1.0,0.8648648648648649,3.6007736031844053,5.1751716318549965,6.154113555604468,3.84830192915104,16,21,13,37,0,0,0,0,72,67,75,51,16,21,13,37,12,12,12,12
64,0.1,0.8,0.8,1.0,0.8571428571428571,3.7612476688462797,5.346567186229301,7.43892179080419,3.9824691820131597,5,5,11,14,5,5,8,9,88,88,85,83,0,0,3,5,7,7,4,3
65,0.1,0.875,0.75,0.7391304347826086,0.9310344827586207,3.755589049606037,5.421158534969496,6.657510513318039,4.10125834524894,8,8,23,29,8,8,5,5,88,88,70,64,0,0,18,24,4,4,7,7
66,0.1,0.8,1.0,1.0,0.9583333333333334,3.681783046878735,5.374284501150524,7.2337084121376,3.828168474377535,5,10,19,24,0,0,9,0,83,78,78,64,5,10,10,24,12,12,3,12
67,0.1,0.8571428571428571,0.9,1.0,0.96,3.9501882524301886,5.760685788806972,7.13549392225799,4.230537058204162,21,10,5,25,5,0,0,5,72,78,83,68,16,10,5,20,7,12,12,7
68,0.1,0.7777777777777778,0.9629629629629629,1.0,1.0,3.6394180037011825,5.391946096995481,6.3269938274779,4.158891887472038,9,27,10,16,5,5,0,4,84,66,78,76,4,22,10,12,7,7,12,8
69,0.1,,0.6666666666666666,0.8,1.0,,5.719389454790882,7.037452744129938,4.6273181343062735,0,9,5,7,0,0,0,3,88,79,83,84,0,9,5,4,12,12,12,9
70,0.1,1.0,1.0,,1.0,3.7107908506027494,5.420035479663369,,4.325098599631742,4,5,0,20,0,0,0,0,84,83,88,68,4,5,0,20,12,12,12,12
71,0.1,0.9411764705882353,0.875,0.875,0.9130434782608695,3.8773996224929563,5.554138444389192,7.181146880248536,4.164342083073684,17,16,8,23,9,4,4,5,80,76,84,70,8,12,4,18,3,8,8,7
72,0.1,0.8666666666666667,0.9565217391304348,,0.9,3.7146545537099667,5.792640971748318,,3.99422249813125,15,23,0,30,0,4,0,0,73,69,88,58,15,19,0,30,12,8,12,12
73,0.1,0.8,0.7692307692307693,,0.9642857142857143,3.660484562761597,5.017287730841785,,3.9663444313842477,5,13,0,28,0,0,0,0,83,75,88,60,5,13,0,28,12,12,12,12
74,0.1,,0.9411764705882353,0.75,0.9375,,5.025684349347846,5.935555335378543,3.985766478940026,0,17,4,32,0,9,4,8,88,80,88,64,0,8,0,24,12,3,8,4
75,0.1,1.0,0.9642857142857143,0.75,1.0,3.7052043885036463,5.991201454388789,6.324400304008924,4.194593269361541,4,28,8,19,0,0,0,5,84,60,80,74,4,28,8,14,12,12,12,7
76,0.1,,1.0,0.9565217391304348,0.8867924528301887,,5.226690573020679,7.007316944620532,3.7529265162651786,0,15,23,53,0,0,3,9,88,73,68,44,0,15,20,44,12,12,9,3
77,0.1,0.5833333333333334,0.875,1.0,0.9310344827586207,3.5462889295101636,5.370946146699152,7.177172678772503,3.8243675867963307,12,16,18,29,0,4,5,3,76,76,75,62,12,12,13,26,12,8,7,9
78,0.1,0.9230769230769231,0.9333333333333333,0.9230769230769231,1.0,3.4404047947812706,5.143701243498958,5.537702840053454,3.6635444509667536,13,15,13,18,5,5,5,5,80,78,80,75,8,10,8,13,7,7,7,7
79,0.1,0.5384615384615384,0.9310344827586207,0.75,0.8823529411764706,3.894001254518973,6.122413612229302,7.140804353780654,4.313030797740005,13,29,8,17,5,0,0,0,80,59,80,71,8,29,8,17,7,12,12,12
80,0.1,0.8333333333333334,0.8,0.9285714285714286,1.0,3.4882233327723786,5.021989437208103,6.699447753775748,3.926347997306435,6,15,14,23,0,0,0,5,82,73,74,70,6,15,14,18,12,12,12,7
81,0.1,0.75,0.9285714285714286,1.0,1.0,3.798805779013159,6.18900650793788,6.988974457604815,4.245526837667165,12,42,11,14,9,7,7,4,85,53,84,78,3,35,4,10,3,5,5,8
82,0.1,0.8666666666666667,0.9473684210526315,0.9047619047619048,0.9411764705882353,3.526077662969064,4.919103827362588,6.50997038541807,3.794961122446453,15,19,21,17,5,5,7,7,78,74,74,78,10,14,14,10,7,7,5,5
83,0.1,0.8235294117647058,0.8636363636363636,0.7692307692307693,0.75,3.7313744717048483,5.525239647774035,6.467356350922144,4.008382615963391,17,22,13,40,7,4,3,7,78,70,78,55,10,18,10,33,5,8,9,5
84,0.1,0.5,0.8461538461538461,1.0,0.75,3.6069163978675904,5.2919290319202394,6.588797525355932,4.169678771653681,4,13,5,4,0,4,0,0,84,79,83,84,4,9,5,4,12,8,12,12
85,0.1,0.875,0.9285714285714286,1.0,0.9565217391304348,3.728188629053215,5.745850508967694,7.368356881392684,3.9982398255386706,8,14,18,23,0,0,0,4,80,74,70,69,8,14,18,19,12,12,12,8
86,0.1,0.75,1.0,0.5,0.8947368421052632,3.5646815802329455,4.852322876585874,5.876726633418748,3.7931880373276656,8,5,4,19,0,0,0,0,80,83,84,69,8,5,4,19,12,12,12,12
87,0.1,0.9,0.7391304347826086,0.96,0.9523809523809523,3.6794966918314236,5.301101177585749,7.110740409693147,3.8804578179849933,20,23,25,42,5,3,7,12,73,68,70,58,15,20,18,30,7,9,5,0
88,0.1,0.8,0.8636363636363636,1.0,0.8888888888888888,3.6156856415622927,5.142530067202587,7.098868328049096,3.8525570490464998,5,22,9,18,5,9,9,8,88,75,88,78,0,13,0,10,7,3,3,4
89,0.1,0.8571428571428571,0.96,0.8695652173913043,0.9259259259259259,3.742931169662775,5.726129918636605,6.821673540757423,3.9675046125473377,14,25,23,27,4,7,9,0,78,70,74,61,10,18,14,27,8,5,3,12
90,0.1,0.84,0.9459459459459459,0.5,0.8421052631578947,3.8254251960961825,6.1134324474650805,6.621327927835308,3.944488940578889,25,37,4,38,5,9,4,5,68,60,88,55,20,28,0,33,7,3,8,7
91,0.1,0.6,0.9047619047619048,0.8333333333333334,0.9310344827586207,3.6082112747319797,5.6503533096090575,6.584713243860793,3.8699061666428296,5,21,24,29,0,4,0,0,83,71,64,59,5,17,24,29,12,8,12,12
92,0.1,0.625,0.94,0.8,0.8958333333333334,3.4548323989212175,5.504387404778256,6.342703140339188,3.658482232936841,8,50,10,48,3,12,0,8,83,50,78,48,5,38,10,40,9,0,12,4
93,0.1,,0.8333333333333334,1.0,0.8333333333333334,,5.038656395728757,6.4442767636348846,4.2807136786475,0,6,10,12,0,3,5,8,88,85,83,84,0,3,5,4,12,9,7,4
94,0.1,0.5714285714285714,0.8571428571428571,0.8947368421052632,1.0,3.7679642660549573,5.302937574230175,7.250887126754494,4.3191151288415295,7,14,19,20,0,5,5,12,81,79,74,80,7,9,14,8,12,7,7,0
95,0.1,0.6,0.8333333333333334,0.8787878787878788,0.8461538461538461,3.561141996785116,5.4170070908033425,6.487229499981818,3.7282797229742206,35,24,33,39,5,4,8,4,58,68,63,53,30,20,25,35,7,8,4,8
96,0.1,0.6428571428571429,0.8928571428571429,0.8888888888888888,0.85,3.584445551360017,5.439838008885553,6.837189736680803,3.862996639561131,14,28,27,40,0,9,7,0,74,69,68,48,14,19,20,40,12,3,5,12
97,0.1,0.7368421052631579,0.875,0.9473684210526315,0.9047619047619048,3.5419010290861457,5.479588882453822,6.397429598728912,3.698016197198359,19,40,19,42,4,7,4,4,73,55,73,50,15,33,15,38,8,5,8,8
98,0.1,0.7419354838709677,0.6666666666666666,0.7692307692307693,0.7777777777777778,3.78030883948239,5.388401425744776,6.417513002058119,3.7892589551056095,31,18,26,27,3,5,3,4,60,75,65,65,28,13,23,23,9,7,9,8
99,0.1,0.5555555555555556,0.7777777777777778,1.0,0.8717948717948718,3.704746989706083,5.0842603250586125,7.193083961398841,4.1990184370808805,9,9,20,39,5,5,5,8,84,84,73,57,4,4,15,31,7,7,7,4
100,0.2,0.7142857142857143,0.8636363636363636,0.42857142857142855,0.9130434782608695,3.624607844510294,5.586786856599145,6.961979056781493,3.98042790564716,7,22,7,46,0,4,0,5,81,70,81,47,7,18,7,41,12,8,12,7
101,0.2,0.8421052631578947,0.8421052631578947,0.8333333333333334,0.9310344827586207,3.6827442154069296,5.550438257080648,6.600175471538468,3.817190254479644,19,19,24,29,9,5,9,5,78,74,73,64,10,14,15,24,3,7,3,7
102,0.2,0.8,0.9473684210526315,0.85,1.0,3.651854967481311,5.099072082873879,6.479070187193441,3.929642999645686,15,19,20,23,5,5,5,5,78,74,73,70,10,14,15,18,7,7,7,7
103,0.2,0.7692307692307693,1.0,0.92,0.9411764705882353,3.6302206693669565,5.528568458340171,7.046701170613959,3.8693779953261687,13,18,25,34,0,4,0,0,75,74,63,54,13,14,25,34,12,8,12,12
104,0.2,0.8888888888888888,0.9285714285714286,0.7857142857142857,0.875,3.759024456800253,5.583819671577109,6.749105214661111,4.220829533505047,9,14,14,24,0,0,5,0,79,74,79,64,9,14,9,24,12,12,7,12
105,0.2,0.7647058823529411,0.9318181818181818,0.8571428571428571,1.0,3.841053781144442,6.201038490005157,7.335266013616279,4.176867730175842,17,44,14,12,12,5,9,9,83,49,83,85,5,39,5,3,0,7,3,3
106,0.2,0.7857142857142857,0.9166666666666666,0.8888888888888888,0.8571428571428571,3.7109004948718405,5.696279427721137,6.578547255145269,4.046876288679866,14,24,9,14,9,9,9,9,83,73,88,83,5,15,0,5,3,3,3,3
107,0.2,0.8275862068965517,0.8947368421052632,0.7142857142857143,0.9285714285714286,3.6595642860778352,4.876781216253065,6.479756515967283,3.803954890139854,29,19,14,14,5,5,5,5,64,74,79,79,24,14,9,9,7,7,7,7
108,0.2,0.8571428571428571,0.9444444444444444,0.75,0.9523809523809523,3.569790311683174,5.159670276226737,7.206413169719661,3.781161570247485,14,18,4,21,4,3,4,7,78,73,88,74,10,15,0,14,8,9,8,5
109,0.2,0.7777777777777778,0.7142857142857143,0.8181818181818182,0.875,3.776195506032961,5.40324204461126,6.353997576538862,4.312481347091848,9,7,11,8,9,0,4,4,88,81,81,84,0,7,7,4,3,12,8,8
110,0.2,0.9,0.9333333333333333,1.0,0.967741935483871,3.6714226082563073,5.357929670513259,6.287803830136056,4.063694125560855,10,15,4,31,5,0,4,9,83,73,88,66,5,15,0,22,7,12,8,3
111,0.2,,0.8888888888888888,,0.9210526315789473,,5.225887149513544,,3.869269874647747,0,9,0,38,0,9,0,8,88,88,88,58,0,0,0,30,12,3,12,4
112,0.2,0.88,0.9545454545454546,0.8947368421052632,1.0,3.7275555382139567,5.820154795822129,7.086461145939734,3.994877210791821,25,44,19,36,8,12,0,9,71,56,69,61,17,32,19,27,4,0,12,3
113,0.2,0.8333333333333334,0.85,1.0,0.9459459459459459,3.739384392538095,5.648838002256502,7.952486762881845,3.973482784373271,18,20,35,37,0,4,3,4,70,72,56,55,18,16,32,33,12,8,9,8
114,0.2,0.6923076923076923,0.8888888888888888,0.8518518518518519,0.88,3.744711418640736,5.508805229767258,7.43618381288498,4.029656686358238,13,36,27,25,5,5,5,0,80,57,66,63,8,31,22,25,7,7,7,12
115,0.2,0.8333333333333334,0.88,0.9473684210526315,0.8888888888888888,3.692230456308032,5.701936374162309,6.3646048426962984,3.894356695990842,12,25,19,36,5,5,5,5,81,68,74,57,7,20,14,31,7,7,7,7
116,0.2,1.0,0.9166666666666666,0.9333333333333333,0.925,3.813544058697544,5.415518571869967,7.036327222099725,4.227544759576007,8,12,15,40,5,4,5,9,85,80,78,57,3,8,10,31,7,8,7,3
117,0.2,0.4,0.9333333333333333,1.0,0.9230769230769231,3.6387272207114387,5.078309388208639,6.799002801681962,3.9407799252200166,5,15,4,13,0,0,0,0,83,73,84,75,5,15,4,13,12,12,12,12
118,0.2,0.9,0.8947368421052632,0.8,0.9565217391304348,3.6440575207169927,5.929392670086769,6.835037494559957,3.816703762700797,10,38,10,23,0,5,0,0,78,55,78,65,10,33,10,23,12,7,12,12
119,0.2,1.0,0.84,0.8666666666666667,1.0,3.6361746864082978,5.51053404125102,6.6115405646250105,3.8107915391238376,13,25,15,23,5,5,8,5,80,68,81,70,8,20,7,18,7,7,4,7
120,0.2,0.8,1.0,0.9,0.9090909090909091,3.4974242760560417,5.083145760118268,5.954533461325934,3.6615309597611794,15,11,20,33,5,3,5,8,78,80,73,63,10,8,15,25,7,9,7,4
121,0.2,0.3333333333333333,1.0,1.0,0.8571428571428571,3.630689791071386,5.522509526520795,6.393721576561313,3.9782199126428623,3,3,3,28,3,3,3,8,88,88,88,68,0,0,0,20,9,9,9,4
122,0.2,0.8064516129032258,0.8421052631578947,0.9444444444444444,0.8260869565217391,3.724736581492144,5.365833856847803,7.123469835981366,3.723605640041662,31,19,54,46,5,8,8,8,62,77,42,50,26,11,46,38,7,4,4,4
123,0.2,0.8,0.8421052631578947,1.0,0.9642857142857143,3.8080043609159233,5.523048199068107,6.76799895673139,4.146641480328681,5,19,5,28,5,5,0,5,88,74,83,65,0,14,5,23,7,7,12,7
124,0.2,0.8,1.0,0.8,0.925,3.739096662980219,5.1791562574899475,6.950524729567286,4.210777558807948,5,8,30,40,0,5,5,3,83,85,63,51,5,3,25,37,12,7,7,9
125,0.2,1.0,0.96,0.9444444444444444,0.9310344827586207,3.7369015878148044,5.716865841529345,6.705754152512027,3.8130569083355152,15,25,18,29,5,9,5,5,78,72,75,64,10,16,13,24,7,3,7,7
126,0.2,0.875,0.8888888888888888,1.0,0.96,3.792101980985822,5.143197672541805,7.482579237763722,4.131634996765563,8,9,4,25,5,5,0,3,85,84,84,66,3,4,4,22,7,7,12,9
127,0.2,0.84375,0.9473684210526315,0.9130434782608695,0.9230769230769231,3.6073646135214608,5.383374567365105,6.906866071859187,3.7095270743179194,32,38,23,52,5,0,5,5,61,50,70,41,27,38,18,47,7,12,7,7
128,0.2,1.0,0.9375,1.0,0.8823529411764706,3.519089285320006,5.7908645709279645,6.031063531281412,4.078599377677513,5,32,11,17,5,8,8,3,88,64,85,74,0,24,3,14,7,4,4,9
129,0.2,0.7777777777777778,0.8717948717948718,1.0,0.8888888888888888,3.5209528334632827,6.003841910658721,6.26899207802553,3.9675041700592613,9,39,5,9,5,5,5,5,84,54,88,84,4,34,0,4,7,7,7,7
130,0.2,0.9,0.9,0.96,0.92,3.5552773212554074,5.433813444872389,7.233430921230662,3.7237752679670835,10,20,25,25,5,5,5,5,83,73,68,68,5,15,20,20,7,7,7,7
131,0.2,0.6666666666666666,0.8421052631578947,0.8888888888888888,0.8076923076923077,3.699409236998837,5.427690573144105,6.9477588802540895,3.9934322704801937,18,19,18,26,3,4,3,7,73,73,73,69,15,15,15,19,9,8,9,5
132,0.2,0.7857142857142857,0.9130434782608695,0.967741935483871,0.8169014084507042,3.803820442641606,5.479248800317975,7.211550003199787,3.9290377237968865,28,46,31,71,4,9,5,9,64,51,62,26,24,37,26,62,8,3,7,3
133,0.2,0.75,1.0,0.875,0.96,3.5380441320795004,5.400163910536945,6.199257539222831,3.9863547119427585,8,18,8,25,8,8,8,8,88,78,88,71,0,10,0,17,4,4,4,4
134,0.2,0.6956521739130435,0.8125,0.8947368421052632,0.7916666666666666,3.5897507107921482,5.357396375567765,6.753179440398837,3.8755056631884535,23,16,19,24,4,0,4,9,69,72,73,73,19,16,15,15,8,12,8,3
135,0.2,0.8421052631578947,0.8648648648648649,0.8235294117647058,0.8181818181818182,3.747657508183415,5.818337378413625,6.838400525007562,4.0224730577685035,19,37,17,22,9,4,4,9,78,55,75,75,10,33,13,13,3,8,8,3
136,0.2,0.6666666666666666,0.9375,1.0,0.9090909090909091,3.7031502970214674,5.891729102276088,6.557988879765641,4.039330429164558,3,48,3,33,3,8,3,8,88,48,88,63,0,40,0,25,9,4,9,4
137,0.2,0.8260869565217391,0.8958333333333334,0.8947368421052632,0.9166666666666666,3.750436254813708,5.98351642216365,6.879755466211724,4.008366143543839,23,48,19,24,9,12,9,0,74,52,78,64,14,36,10,24,3,0,3,12
138,0.2,0.5,0.9166666666666666,0.8148148148148148,0.875,3.6295924712153202,5.14287257287027,6.956421734937119,3.7120008144174754,10,12,27,24,5,4,5,5,83,80,66,69,5,8,22,19,7,8,7,7
139,0.2,,0.9142857142857143,0.8571428571428571,1.0,,6.111765122360486,6.707717293811474,4.289837565816546,0,35,14,20,0,5,4,5,88,58,78,73,0,30,10,15,12,7,8,7
140,0.2,1.0,0.8333333333333334,1.0,0.9565217391304348,3.617012549520336,5.304518842506526,6.104791394248982,4.094115457433464,4,18,7,23,0,5,0,5,84,75,81,70,4,13,7,18,12,7,12,7
141,0.2,0.8,0.8571428571428571,0.8,0.9285714285714286,3.730607487186224,5.711125767347366,6.365693657543807,3.9453475626851193,5,42,10,28,5,5,0,5,88,51,78,65,0,37,10,23,7,7,12,7
142,0.2,0.8947368421052632,0.9047619047619048,0.8928571428571429,1.0,3.751946295674179,5.419209696571409,6.392576055733256,4.017113847804531,19,21,28,9,4,3,4,0,73,70,64,79,15,18,24,9,8,9,8,12
143,0.2,0.6153846153846154,0.8823529411764706,0.9333333333333333,0.9069767441860465,3.7069979676453055,5.716485496546863,7.076287668792158,3.994602588167423,13,34,15,43,4,4,0,9,79,58,73,54,9,30,15,34,8,8,12,3
144,0.2,0.7368421052631579,0.918918918918919,0.7777777777777778,0.851063829787234,3.7208977122285183,5.925559498317564,6.878196654713836,4.010182705590047,19,37,18,47,4,0,0,5,73,51,70,46,15,37,18,42,8,12,12,7
145,0.2,0.7857142857142857,0.8,0.8571428571428571,0.9019607843137255,3.9569701974544786,5.733765479935211,6.978915593480012,4.174332736930428,14,25,14,51,0,0,0,8,74,63,74,45,14,25,14,43,12,12,12,4
146,0.2,0.9333333333333333,0.9285714285714286,0.9333333333333333,0.9565217391304348,3.800692320419517,5.532181847561262,7.124136460324996,4.031002045624852,15,14,15,23,5,0,5,8,78,74,78,73,10,14,10,15,7,12,7,4
147,0.2,1.0,0.9473684210526315,0.7857142857142857,0.9137931034482759,3.6869006218178644,5.50051556093423,6.500191594016136,4.004703937901605,4,19,14,58,4,4,9,4,88,73,83,34,0,15,5,54,8,8,3,8
148,0.2,1.0,1.0,0.8,1.0,3.6478889594029917,5.064925395157764,6.204731432331738,4.100659598377086,5,10,5,18,5,5,5,5,88,83,88,75,0,5,0,13,7,7,7,7
149,0.2,0.8,0.9354838709677419,,0.875,3.7840760631128534,5.460108939928552,,4.077828515132803,15,31,0,24,5,12,0,5,78,69,88,69,10,19,0,19,7,0,12,7
150,0.2,0.8947368421052632,0.9230769230769231,1.0,0.9565217391304348,3.7446985018764742,5.43352241369252,7.900216290355471,3.926863431397925,19,13,24,23,4,4,4,0,73,79,68,65,15,9,20,23,8,8,8,12
151,0.2,0.7333333333333333,0.9166666666666666,0.7647058823529411,0.8723404255319149,3.8222817443917156,5.4313023475898765,7.01258653412084,3.979843339984375,15,12,17,47,5,4,5,9,78,80,76,50,10,8,12,38,7,8,7,3
152,0.2,0.8,0.8703703703703703,0.9142857142857143,0.8269230769230769,3.740938969870784,5.938244052888249,6.885716844645046,3.834205856308403,25,54,35,52,5,8,5,9,68,42,58,45,20,46,30,43,7,4,7,3
153,0.2,0.8,0.8947368421052632,1.0,1.0,3.609718633509469,5.1788853391779455,6.638502477747463,4.034266078429272,5,19,9,9,0,4,4,0,83,73,83,79,5,15,5,9,12,8,8,12
154,0.2,0.7777777777777778,0.8333333333333334,0.9,0.8,3.653459230584266,5.30663211836012,7.186511362733503,3.891358351310438,9,12,10,20,5,5,5,5,84,81,83,73,4,7,5,15,7,7,7,7
155,0.2,0.6,0.7142857142857143,0.8,0.90625,3.631408289330686,5.314077172525051,6.8682313271677655,3.9335065619368765,10,14,10,32,0,0,0,7,78,74,78,63,10,14,10,25,12,12,12,5
156,0.2,,0.9285714285714286,1.0,0.9615384615384616,,6.007715993037679,6.776380118032607,4.424887480283163,0,28,4,26,0,8,0,5,88,68,84,67,0,20,4,21,12,4,12,7
157,0.2,0.7222222222222222,0.9523809523809523,0.9444444444444444,0.8484848484848485,3.5386138536841183,4.984183129899882,6.32301128357619,3.901250698393971,18,21,18,33,0,12,0,7,70,79,70,62,18,9,18,26,12,0,12,5
158,0.2,0.9166666666666666,0.8974358974358975,0.8571428571428571,0.9705882352941176,3.4698735494241872,5.583392546016851,6.130397572961256,3.514673046279758,24,39,28,34,9,9,9,9,73,58,69,63,15,30,19,25,3,3,3,3
159,0.2,0.8888888888888888,0.875,0.9166666666666666,0.9655172413793104,3.6038039799886783,5.576899114708702,6.767940659862364,3.9177221432915514,9,40,12,29,0,3,3,0,79,51,79,59,9,37,9,29,12,9,9,12
160,0.2,0.9,0.8529411764705882,1.0,0.9117647058823529,3.47351732632442,5.238519726223237,6.897003415242541,3.6567515165036126,10,34,9,34,5,9,5,5,83,63,84,59,5,25,4,29,7,3,7,7
161,0.2,0.9090909090909091,0.8636363636363636,1.0,0.9285714285714286,3.6918935434972044,5.276213313037496,7.062003620427136,4.066302081058539,11,22,9,14,5,12,3,8,82,78,82,82,6,10,6,6,7,0,9,4
162,0.2,0.8571428571428571,0.75,1.0,0.9,3.7830150827110023,5.9650712359470495,7.309840171773101,4.329437285095783,7,12,8,20,4,4,5,12,85,80,85,80,3,8,3,8,8,8,7,0
163,0.2,0.8125,1.0,1.0,0.9523809523809523,3.6074739528389586,5.367415768881835,6.3227211686178935,3.8827409238389556,16,30,18,42,0,5,5,5,72,63,75,51,16,25,13,37,12,7,7,7
164,0.2,0.8888888888888888,0.75,1.0,0.8571428571428571,3.78341202162871,5.258076728429286,7.448693957558022,3.950283289721835,9,8,11,14,9,5,8,9,88,85,85,83,0,3,3,5,3,7,4,3
165,0.2,0.875,0.75,0.7391304347826086,0.9310344827586207,3.756413300776992,5.424284771363381,6.6575000639612245,4.095511695307098,8,8,23,29,8,8,5,5,88,88,70,64,0,0,18,24,4,4,7,7
166,0.2,0.8,1.0,1.0,0.9642857142857143,3.6955140152394703,5.255652744082197,7.234547798898352,3.9592418387836585,5,5,19,28,0,0,9,4,83,83,78,64,5,5,10,24,12,12,3,8
167,0.2,0.8571428571428571,0.9,1.0,0.9655172413793104,3.9501229270900935,5.780243499142689,7.1698091587057515,4.288039782876537,21,10,5,29,5,0,0,5,72,78,83,64,16,10,5,24,7,12,12,7
168,0.2,0.7777777777777778,0.9629629629629629,1.0,1.0,3.6417339756655642,5.4048348873403045,6.3842776918259005,4.084991509107077,9,27,15,21,5,5,5,9,84,66,78,76,4,22,10,12,7,7,7,3
169,0.2,,0.6666666666666666,0.8,1.0,,5.728081116363899,7.0313173456139335,4.869211823583912,0,9,5,7,0,0,0,3,88,79,83,84,0,9,5,4,12,12,12,9
170,0.2,1.0,1.0,,0.96,3.71800388107807,5.439663929993939,,4.210202781071087,4,5,0,25,0,0,0,5,84,83,88,68,4,5,0,20,12,12,12,7
171,0.2,0.9411764705882353,0.9047619047619048,0.8461538461538461,0.9130434782608695,3.876892931879455,5.6111808031363966,7.250119193894081,4.145370914273295,17,21,13,23,9,9,9,5,80,76,84,70,8,12,4,18,3,3,3,7
172,0.2,0.8666666666666667,0.9565217391304348,,0.9,3.718111700563569,5.785864183067808,,3.927936950164782,15,23,0,30,0,4,0,0,73,69,88,58,15,19,0,30,12,8,12,12
173,0.2,0.9,0.9047619047619048,,1.0,3.744530452808102,5.221235267252697,,4.04990129926189,10,21,0,23,5,8,0,0,83,75,88,65,5,13,0,23,7,4,12,12
174,0.2,0.7777777777777778,0.9230769230769231,0.75,0.9375,3.4825207705928753,4.948721044383153,5.951197643271433,3.871727135895849,9,13,4,32,9,9,4,8,88,84,88,64,0,4,0,24,3,3,8,4
175,0.2,1.0,0.9642857142857143,0.75,0.9473684210526315,3.70746461761492,5.986266173895094,6.342274190007349,4.0353939286476,4,28,8,19,0,0,0,5,84,60,80,74,4,28,8,14,12,12,12,7
176,0.2,,1.0,0.9565217391304348,0.9166666666666666,,5.243667046290903,7.047335302604539,3.8791073638038385,0,15,23,48,0,0,3,9,88,73,68,49,0,15,20,39,12,12,9,3
177,0.2,0.7058823529411765,0.9230769230769231,1.0,0.8620689655172413,3.5729824107068096,5.547903207035441,7.185005753078875,3.9217365022365183,17,26,18,29,5,4,5,3,76,66,75,62,12,22,13,26,7,8,7,9
178,0.2,0.9230769230769231,0.9333333333333333,0.9230769230769231,0.9615384615384616,3.442800862300971,5.1505948494655,5.550215234369039,3.891110197640521,13,15,13,26,5,5,5,5,80,78,80,67,8,10,8,21,7,7,7,7
179,0.2,0.5384615384615384,0.92,0.75,0.9523809523809523,3.9004646472255633,6.088967218050751,7.145698116039883,4.184921260863982,13,25,8,21,5,0,0,8,80,63,80,75,8,25,8,13,7,12,12,4
180,0.2,0.8181818181818182,0.8,0.9285714285714286,1.0,3.507025127121028,5.050708543182761,6.7697001265938495,3.870894807132861,11,15,14,33,5,0,0,5,82,73,74,60,6,15,14,28,7,12,12,7
181,0.2,0.75,0.9487179487179487,1.0,0.9473684210526315,3.798344167123189,6.181113499850789,7.00642804639071,4.054495670679477,12,39,12,19,9,4,12,9,85,53,88,78,3,35,0,10,3,8,0,3
182,0.2,0.8666666666666667,0.9473684210526315,0.8695652173913043,1.0,3.5278088121892255,4.923925967001372,6.381067306479211,3.905238755887493,15,19,23,22,5,5,9,12,78,74,74,78,10,14,14,10,7,7,3,0
183,0.2,0.6923076923076923,0.8636363636363636,0.7692307692307693,0.85,3.741481828048662,5.545529791636048,6.492293838553978,3.992451093379077,13,22,13,40,3,4,3,7,78,70,78,55,10,18,10,33,9,8,9,5
184,0.2,0.625,0.8461538461538461,1.0,0.875,3.6667003688341184,5.311120965820288,6.634778039985752,4.32664288199209,8,13,5,8,4,4,0,4,84,79,83,84,4,9,5,4,8,8,12,8
185,0.2,0.875,0.9285714285714286,1.0,0.9130434782608695,3.738780291474309,5.758220974640479,7.394029444159382,3.9052516491613263,8,14,18,23,0,0,0,4,80,74,70,69,8,14,18,19,12,12,12,8
186,0.2,0.75,1.0,0.5,0.875,3.5685231157355135,4.848519162823126,5.874032370966365,3.9227451323874623,8,5,4,24,0,0,0,5,80,83,84,69,8,5,4,19,12,12,12,7
187,0.2,0.9333333333333333,0.84375,0.9333333333333333,0.8666666666666667,3.688042628316504,5.296840056106969,7.1508542482807576,3.8514692524734855,15,32,30,45,5,8,12,12,78,64,70,55,10,24,18,33,7,4,0,0
188,0.2,0.8,0.8636363636363636,1.0,0.8888888888888888,3.6229219421253527,5.142430877313848,7.0985940447627724,3.832455973571327,5,22,9,18,5,9,9,8,88,75,88,78,0,13,0,10,7,3,3,4
189,0.2,0.8421052631578947,0.9666666666666667,0.8695652173913043,0.9259259259259259,3.74616963964173,5.775553570717482,6.824685482143953,3.9643093989431892,19,30,23,27,9,12,9,0,78,70,74,61,10,18,14,27,3,0,3,12
190,0.2,0.84375,0.9459459459459459,0.5,0.9047619047619048,3.830166894306373,6.112382966339733,6.668682652818413,4.006173044964406,32,37,4,42,9,9,4,9,65,60,88,55,23,28,0,33,3,3,8,3
191,0.2,0.6956521739130435,0.9047619047619048,0.8275862068965517,0.9393939393939394,3.570991128134415,5.645558585534992,6.683005642122793,3.843494324815655,23,21,29,33,4,4,5,0,69,71,64,55,19,17,24,33,8,8,7,12
192,0.2,0.625,0.9347826086956522,0.8666666666666667,0.9166666666666666,3.4646973877898457,5.403583346528811,6.529744634531051,3.667985370108146,8,46,15,48,3,8,5,8,83,50,78,48,5,38,10,40,9,4,7,4
193,0.2,0.8,0.8333333333333334,1.0,1.0,3.6036437405124695,5.06557896031525,6.44957639283092,4.332401445272715,5,6,10,12,5,3,5,8,88,85,83,84,0,3,5,4,7,9,7,4
194,0.2,0.5,0.8571428571428571,0.8947368421052632,1.0,3.778314222344491,5.313581031391228,7.258798985207233,4.308534747104711,12,14,19,20,5,5,5,12,81,79,74,80,7,9,14,8,7,7,7,0
195,0.2,0.6,0.8620689655172413,0.896551724137931,0.8461538461538461,3.564073949111613,5.479778687593929,6.455751707118674,3.6979076177407117,35,29,29,39,5,9,8,4,58,68,67,53,30,20,21,35,7,3,4,8
196,0.2,0.7894736842105263,0.8928571428571429,0.90625,0.9137931034482759,3.625992226345251,5.444436458102607,6.944311598218526,3.743306138060742,19,28,32,58,5,9,12,8,74,69,68,38,14,19,20,50,7,3,0,4
197,0.2,0.5,0.875,0.9473684210526315,0.9047619047619048,3.4771282312446816,5.497877944863605,6.399355713466129,3.7419503694107354,4,40,19,42,4,7,4,4,88,55,73,50,0,33,15,38,8,5,8,8
198,0.2,0.7714285714285715,0.75,0.7692307692307693,0.7407407407407407,3.795129698168921,5.507897104856208,6.4228474442359005,3.768094997354433,35,28,26,27,7,5,3,4,60,65,65,65,28,23,23,23,5,7,9,8
199,0.2,0.5555555555555556,0.7777777777777778,1.0,0.8974358974358975,3.7098640712146373,5.089126436311382,7.217705913451006,4.188620318334879,9,9,20,39,5,5,5,8,84,84,73,57,4,4,15,31,7,7,7,4
200,0.3,0.75,0.8636363636363636,0.5833333333333334,0.9130434782608695,3.682250420949516,5.607381344808695,7.061569601597367,3.9713718805960965,16,22,12,46,9,4,5,5,81,70,81,47,7,18,7,41,3,8,7,7
201,0.3,0.8421052631578947,0.8421052631578947,0.8333333333333334,0.9393939393939394,3.6831250299852956,5.557924243902383,6.597472722044118,3.715561366601032,19,19,24,33,9,5,9,9,78,74,73,64,10,14,15,24,3,7,3,3
202,0.3,0.8,0.9473684210526315,0.85,1.0,3.6537562748627033,5.105819092866992,6.482462940885843,3.925730830871023,15,19,20,23,5,5,5,5,78,74,73,70,10,14,15,18,7,7,7,7
203,0.3,0.7777777777777778,1.0,0.9117647058823529,0.9487179487179487,3.668063213367122,5.615358068185103,7.156205466664677,4.007047965344821,18,23,34,39,5,9,9,5,75,74,63,54,13,14,25,34,7,3,3,7
204,0.3,0.8888888888888888,0.9285714285714286,0.7857142857142857,0.875,3.7681200571066205,5.60448934151055,6.756783078473766,4.155855083487732,9,14,14,24,0,0,5,0,79,74,79,64,9,14,9,24,12,12,7,12
205,0.3,0.7647058823529411,0.9318181818181818,0.8571428571428571,1.0,3.841053781144441,6.220003369442143,7.334282576419133,4.135722170147593,17,44,14,12,12,5,9,9,83,49,83,85,5,39,5,3,0,7,3,3
206,0.3,0.7857142857142857,0.9166666666666666,0.8888888888888888,0.8571428571428571,3.711121112694073,5.697263302743148,6.576596756676081,4.014594173648386,14,24,9,14,9,9,9,9,83,73,88,83,5,15,0,5,3,3,3,3
207,0.3,0.8275862068965517,0.8947368421052632,0.7142857142857143,0.9285714285714286,3.6622341850091247,4.882627042874249,6.485912348096953,3.7156433106656084,29,19,14,14,5,5,5,5,64,74,79,79,24,14,9,9,7,7,7,7
208,0.3,0.8947368421052632,0.9444444444444444,0.8888888888888888,0.9523809523809523,3.606662607788035,5.189456065138036,7.286512757458998,3.7605326184759726,19,18,9,21,9,3,9,7,78,73,88,74,10,15,0,14,3,9,3,5
209,0.3,0.7777777777777778,0.7142857142857143,0.8125,0.9230769230769231,3.776335881585131,5.422837717544374,6.395508533505667,4.220719776590447,9,7,16,13,9,0,9,9,88,81,81,84,0,7,7,4,3,12,3,3
210,0.3,0.7857142857142857,0.9333333333333333,1.0,0.9032258064516129,3.661439597117976,5.381707659118233,6.2974240342568795,3.8280868165807624,14,15,4,31,9,0,4,9,83,73,88,66,5,15,0,22,3,12,8,3
211,0.3,0.8,0.8888888888888888,,0.84375,3.5454146146993524,5.227250784371862,,3.8948698819794174,5,9,0,32,5,9,0,12,88,88,88,68,0,0,0,20,7,3,12,0
212,0.3,0.88,0.9545454545454546,0.8333333333333334,1.0,3.7316090352568994,5.820154795822129,7.085896750530267,4.023308747828381,25,44,24,36,8,12,5,9,71,56,69,61,17,32,19,27,4,0,7,3
213,0.3,0.8666666666666667,0.75,1.0,0.95,3.760216028861806,5.544813210027191,7.959545860513785,3.977348336818744,15,16,35,40,0,0,3,7,73,72,56,55,15,16,32,33,12,12,9,5
214,0.3,0.6923076923076923,0.8888888888888888,0.8823529411764706,0.8333333333333334,3.746756859773824,5.514535162602277,7.1972360550796,4.101865164360445,13,36,17,30,5,5,5,5,80,57,76,63,8,31,12,25,7,7,7,7
215,0.3,0.8333333333333334,0.896551724137931,0.9473684210526315,0.8888888888888888,3.694572761312522,5.80456236260749,6.377863957633714,3.879951058971713,12,29,19,36,5,9,5,5,81,68,74,57,7,20,14,31,7,3,7,7
216,0.3,1.0,0.9411764705882353,0.9333333333333333,0.85,3.8145922269572043,5.496921796960122,7.027451860101792,4.169210030166586,8,17,15,40,5,9,5,9,85,80,78,57,3,8,10,31,7,3,7,3
217,0.3,0.4,0.9333333333333333,1.0,0.9230769230769231,3.6390364735021725,5.086602127237484,6.816152946520437,3.9352646705136065,5,15,4,13,0,0,0,0,83,73,84,75,5,15,4,13,12,12,12,12
218,0.3,0.9333333333333333,0.8947368421052632,0.8421052631578947,0.9285714285714286,3.6646441428425804,5.935135747549393,7.1021022643774,3.8745788567757624,15,38,19,28,5,5,5,5,78,55,74,65,10,33,14,23,7,7,7,7
219,0.3,1.0,0.84,0.8666666666666667,1.0,3.6413571566186933,5.5165468092388,6.612448793559451,3.7891316211361543,13,25,15,23,5,5,8,5,80,68,81,70,8,20,7,18,7,7,4,7
220,0.3,0.8,1.0,0.9,0.8918918918918919,3.4986392346717587,5.144231277821336,5.960588978125752,3.5212802569673283,15,16,20,37,5,8,5,8,78,80,73,59,10,8,15,29,7,4,7,4
221,0.3,0.75,1.0,1.0,0.8571428571428571,3.7317696563777716,5.542484839600637,6.430509250084637,3.9722721952859095,8,3,3,28,8,3,3,8,88,88,88,68,0,0,0,20,4,9,9,4
222,0.3,0.8387096774193549,0.8421052631578947,0.9444444444444444,0.84,3.7295527944162834,5.370821974362995,7.146694315185637,3.9149648024987944,31,19,54,50,5,8,8,12,62,77,42,50,26,11,46,38,7,4,4,0
223,0.3,0.8888888888888888,0.8421052631578947,1.0,0.9642857142857143,3.7918409189985787,5.525667817969431,6.90031101968677,4.179637293994298,9,19,10,28,5,5,5,5,84,74,83,65,4,14,5,23,7,7,7,7
224,0.3,0.9,1.0,0.8,0.9387755102040817,3.7447568500894706,5.2364176220845655,6.9522709776298175,4.019795453527926,10,12,30,49,5,9,5,12,83,85,63,51,5,3,25,37,7,3,7,0
225,0.3,0.9473684210526315,0.96,0.9545454545454546,1.0,3.7509259734874965,5.719438159744722,6.842380537721195,3.8896625806634293,19,25,22,33,5,9,9,9,74,72,75,64,14,16,13,24,7,3,3,3
226,0.3,0.875,0.8888888888888888,1.0,0.9333333333333333,3.7940240852910327,5.149098430163422,7.542078005885617,4.169291251182282,8,9,4,30,5,5,0,8,85,84,84,66,3,4,4,22,7,7,12,4
227,0.3,0.84375,0.9473684210526315,0.9130434782608695,0.9230769230769231,3.608581843887352,5.410546270049756,6.909173813267946,3.7023753124779466,32,38,23,52,5,0,5,5,61,50,70,41,27,38,18,47,7,12,7,7
228,0.3,1.0,1.0,1.0,0.9285714285714286,3.5216313920531968,5.851582405237466,6.027822283707946,4.039619253442487,5,29,11,14,5,5,8,0,88,64,85,74,0,24,3,14,7,7,4,12
229,0.3,0.7777777777777778,0.8717948717948718,1.0,0.9230769230769231,3.5235892152708392,6.007847327431355,6.26390019137744,3.9369428074472728,9,39,5,13,5,5,5,5,84,54,88,80,4,34,0,8,7,7,7,7
230,0.3,0.9,0.9,0.96,1.0,3.557309735669526,5.432512943834746,7.244349069523574,3.920512205970539,10,20,25,25,5,5,5,5,83,73,68,68,5,15,20,20,7,7,7,7
231,0.3,0.6666666666666666,0.8421052631578947,0.8888888888888888,0.8076923076923077,3.7042718620771016,5.437851571055528,6.965303353789758,3.9121275295999434,18,19,18,26,3,4,3,7,73,73,73,69,15,15,15,19,9,8,9,5
232,0.3,0.7857142857142857,0.9130434782608695,0.967741935483871,0.8169014084507042,3.8123375901137524,5.478431106924519,7.218621959255342,3.9220071684276583,28,46,31,71,4,9,5,9,64,51,62,26,24,37,26,62,8,3,7,3
233,0.3,0.75,1.0,0.875,0.92,3.5390096293835103,5.4046700228386975,6.196622728107723,3.9830190921966424,8,18,8,25,8,8,8,8,88,78,88,71,0,10,0,17,4,4,4,4
234,0.3,0.6956521739130435,0.8571428571428571,0.8947368421052632,0.7916666666666666,3.5961427194353788,5.485590608943207,6.767019514791667,3.8292150762427855,23,21,19,24,4,5,4,9,69,72,73,73,19,16,15,15,8,7,8,3
235,0.3,0.8421052631578947,0.8571428571428571,0.7142857142857143,0.8636363636363636,3.7478612239495726,5.824902703147499,6.750983256570117,3.9933701191891875,19,42,14,22,9,9,4,9,78,55,78,75,10,33,10,13,3,3,8,3
236,0.3,0.875,0.9375,1.0,0.9696969696969697,3.7279751057270714,5.8944256137382,6.587715020579346,3.9422790952537086,8,48,3,33,8,8,3,8,88,48,88,63,0,40,0,25,4,4,9,4
237,0.3,0.8260869565217391,0.8958333333333334,0.8947368421052632,0.9696969696969697,3.750875102519574,5.98351642216365,6.881632521461853,4.035794194319401,23,48,19,33,9,12,9,9,74,52,78,64,14,36,10,24,3,0,3,3
238,0.3,0.5,0.7647058823529411,0.8387096774193549,0.8928571428571429,3.632529092352204,5.050787267199033,7.04424461525416,3.809310900113267,10,17,31,28,5,9,9,9,83,80,66,69,5,8,22,19,7,3,3,3
239,0.3,,0.9230769230769231,0.8571428571428571,0.9583333333333334,,6.202827276509657,6.715503443264342,4.273816611625498,0,39,14,24,0,9,4,9,88,58,78,73,0,30,10,15,12,3,8,3
240,0.3,0.9166666666666666,0.8333333333333334,1.0,0.9130434782608695,3.6825857743140666,5.311692981135199,6.130375581474518,4.051713265050116,12,18,7,23,5,5,0,5,81,75,81,70,7,13,7,18,7,7,12,7
241,0.3,0.8,0.8571428571428571,0.8666666666666667,0.9285714285714286,3.7351439921826795,5.717598873749719,6.4825393819400725,3.9386851939306053,5,42,15,28,5,5,5,5,88,51,78,65,0,37,10,23,7,7,7,7
242,0.3,0.8947368421052632,0.8846153846153846,0.8928571428571429,1.0,3.75749396096394,5.543940893918582,6.4085892217538385,4.101930842600414,19,26,28,13,4,8,4,4,73,70,64,79,15,18,24,9,8,4,8,8
243,0.3,0.6153846153846154,0.9333333333333333,0.9333333333333333,0.8837209302325582,3.7127369347085315,5.764506703879735,7.080198676837183,4.070831259985202,13,30,15,43,4,0,0,9,79,58,73,54,9,30,15,34,8,12,12,3
244,0.3,0.7368421052631579,0.875,0.8636363636363636,0.851063829787234,3.7259760633922414,5.806428267908897,6.94954069361562,3.873039572993571,19,32,22,47,4,5,4,5,73,61,70,46,15,27,18,42,8,7,8,7
245,0.3,0.7857142857142857,0.8666666666666667,0.8571428571428571,0.9019607843137255,3.9628922976068317,5.883732445505931,6.999697497124281,4.296425596533211,14,30,14,51,0,5,0,8,74,63,74,45,14,25,14,43,12,7,12,4
246,0.3,0.9333333333333333,0.9285714285714286,0.9333333333333333,0.9629629629629629,3.802982340255207,5.553892283015462,7.121981268128683,4.1697448712543155,15,14,15,27,5,0,5,8,78,74,78,69,10,14,10,19,7,12,7,4
247,0.3,0.8888888888888888,0.9473684210526315,0.7857142857142857,0.9137931034482759,3.713226185217938,5.511846973870741,6.503683253236844,4.000738016739105,9,19,14,58,9,4,9,4,88,73,83,34,0,15,5,54,3,8,3,8
248,0.3,1.0,1.0,0.8,1.0,3.6472080250736014,5.063715342353294,6.206344726989592,3.955604282731157,5,10,5,18,5,5,5,5,88,83,88,75,0,5,0,13,7,7,7,7
249,0.3,0.8,0.9354838709677419,,0.85,3.7846826086153156,5.460108939928552,,4.030950214212129,15,31,0,20,5,12,0,5,78,69,88,73,10,19,0,15,7,0,12,7
250,0.3,0.8947368421052632,0.8888888888888888,0.9655172413793104,0.8695652173913043,3.7516903470705545,5.3749426231427435,8.11407682464469,4.105695671817111,19,9,29,23,4,4,9,0,73,83,68,65,15,5,20,23,8,8,3,12
251,0.3,0.7777777777777778,0.8235294117647058,0.7647058823529411,0.8723404255319149,3.8163601686145494,5.405408722489169,7.0146471033902955,4.060743427236845,18,17,17,47,5,9,5,9,75,80,76,50,13,8,12,38,7,3,7,3
252,0.3,0.7931034482758621,0.8703703703703703,0.9318181818181818,0.8269230769230769,3.752165122552464,5.943618027328933,7.206433344594425,3.8290393047489273,29,54,44,52,9,8,9,9,68,42,53,45,20,46,35,43,3,4,3,3
253,0.3,0.8,0.9166666666666666,1.0,1.0,3.6168814151679127,5.2476897608175195,6.642131766260002,3.9592203051323147,5,24,9,9,0,9,4,0,83,73,83,79,5,15,5,9,12,3,8,12
254,0.3,0.7777777777777778,0.8333333333333334,0.9,0.8,3.6569728642172468,5.3076495146740905,7.192866360850701,3.920007519883326,9,12,10,20,5,5,5,5,84,81,83,73,4,7,5,15,7,7,7,7
255,0.3,0.6,0.7142857142857143,0.8,0.90625,3.6364650587486693,5.31377905864431,6.9074642602937875,3.945680239500345,10,14,10,32,0,0,0,7,78,74,78,63,10,14,10,25,12,12,12,5
256,0.3,1.0,0.9285714285714286,0.7777777777777778,1.0,3.8940608995374264,6.017308242917482,6.938852910283034,4.418158605670309,5,28,9,26,5,8,5,5,88,68,84,67,0,20,4,21,7,4,7,7
257,0.3,0.7777777777777778,0.9523809523809523,0.9444444444444444,0.8157894736842105,3.55093964030285,4.984183129899882,6.323943293363891,3.9236307026851307,18,21,18,38,0,12,0,12,70,79,70,62,18,9,18,26,12,0,12,0
258,0.3,0.9166666666666666,0.8974358974358975,0.8571428571428571,0.9705882352941176,3.469064897574524,5.582088758369586,6.12805734441629,3.501553358784914,24,39,28,34,9,9,9,9,73,58,69,63,15,30,19,25,3,3,3,3
259,0.3,0.8235294117647058,0.875,0.9166666666666666,1.0,3.5812201325224993,5.587373767555434,6.797980333067874,4.011112424401858,17,40,12,29,8,3,3,0,79,51,79,59,9,37,9,29,4,9,9,12
260,0.3,0.9,0.8529411764705882,1.0,0.9117647058823529,3.4775432195148106,5.237359673468388,6.8999516312784985,3.6109270696700215,10,34,9,34,5,9,5,5,83,63,84,59,5,25,4,29,7,3,7,7
261,0.3,0.9090909090909091,0.8947368421052632,1.0,0.9285714285714286,3.6906861146005494,5.257254189968162,7.088007925865792,4.035590891574649,11,19,9,14,5,12,3,8,82,81,82,82,6,7,6,6,7,0,9,4
262,0.3,0.8571428571428571,0.75,1.0,0.9,3.789972368209476,5.976662597824988,7.324776396167797,4.2980589719265705,7,12,8,20,4,4,5,12,85,80,85,80,3,8,3,8,8,8,7,0
263,0.3,0.8846153846153846,1.0,1.0,0.9285714285714286,3.6713008908722173,5.363062194287591,6.327421392846343,3.8775983590673158,26,30,18,42,5,5,5,5,67,63,75,51,21,25,13,37,7,7,7,7
264,0.3,0.8888888888888888,0.75,1.0,0.9285714285714286,3.7842232586866342,5.258968503421906,7.457535263887622,4.067360398045287,9,8,11,14,9,5,8,9,88,85,85,83,0,3,3,5,3,7,4,3
265,0.3,0.875,0.8,0.7391304347826086,0.9310344827586207,3.757672481037057,5.323050958817793,6.658717138025063,4.223324041903506,8,5,23,29,8,5,5,5,88,88,70,64,0,0,18,24,4,7,7,7
266,0.3,0.7142857142857143,1.0,1.0,1.0,3.6939182284994265,5.272767570755157,7.235385644091266,4.035420924437187,14,5,19,18,9,0,9,4,83,83,78,74,5,5,10,14,3,12,3,8
267,0.3,0.8571428571428571,0.9,1.0,0.9655172413793104,3.9510487817717284,5.799462261527159,7.074183010137307,4.2723995832716195,21,10,10,29,5,0,5,5,72,78,83,64,16,10,5,24,7,12,7,7
268,0.3,0.7777777777777778,0.9629629629629629,1.0,0.9354838709677419,3.644048815554601,5.415503777095516,6.392991664819107,4.017574609075858,9,27,15,31,5,5,5,9,84,66,78,66,4,22,10,22,7,7,7,3
269,0.3,,0.6666666666666666,,1.0,,5.738849314786062,,4.858897860472431,0,9,0,7,0,0,0,3,88,79,88,84,0,9,0,4,12,12,12,9
270,0.3,0.8888888888888888,1.0,1.0,0.92,3.709875274706264,5.459850298158223,6.724434794795014,4.199508127758671,9,5,5,25,5,0,5,5,84,83,88,68,4,5,0,20,7,12,7,7
271,0.3,0.9411764705882353,0.9047619047619048,0.8461538461538461,0.8888888888888888,3.8765587327883178,5.6096936440761915,7.248357709232911,4.0220350296901515,17,21,13,27,9,9,9,9,80,76,84,70,8,12,4,18,3,3,3,3
272,0.3,0.8666666666666667,0.9565217391304348,1.0,0.95,3.722791817626309,5.782841874513739,6.81308014259074,3.7077422948087553,15,23,5,20,0,4,5,0,73,69,88,68,15,19,0,20,12,8,7,12
273,0.3,0.9,0.9047619047619048,1.0,0.9642857142857143,3.74492927196476,5.217762116000315,6.943329821285905,3.980545524352393,10,21,5,28,5,8,5,5,83,75,88,65,5,13,0,23,7,4,7,7
274,0.3,0.7777777777777778,0.9230769230769231,0.7777777777777778,0.9375,3.482865208481212,4.948864055967969,5.853323756790532,3.86403971027587,9,13,9,32,9,9,9,8,88,84,88,64,0,4,0,24,3,3,3,4
275,0.3,1.0,0.9642857142857143,0.75,0.9473684210526315,3.712559310669808,5.987841971485143,6.363000996614855,4.0372987579875215,4,28,8,19,0,0,0,5,84,60,80,74,4,28,8,14,12,12,12,7
276,0.3,1.0,1.0,0.9629629629629629,0.9166666666666666,3.526524182120264,5.262111737279964,7.177276356961984,3.8712643843400003,4,15,27,48,4,0,7,9,88,73,68,49,0,15,20,39,8,12,5,3
277,0.3,0.7058823529411765,0.9032258064516129,1.0,0.896551724137931,3.5742703369887243,5.564603683684645,7.147850727536206,3.8249417300909396,17,31,15,29,5,9,5,3,76,66,78,62,12,22,10,26,7,3,7,9
278,0.3,0.9230769230769231,0.9333333333333333,0.9230769230769231,0.9333333333333333,3.4454176141868156,5.156899370776367,5.561386111618561,3.7340839863349173,13,15,13,30,5,5,5,9,80,78,80,67,8,10,8,21,7,7,7,3
279,0.3,0.5384615384615384,0.9666666666666667,0.6666666666666666,0.8571428571428571,3.9061985066213607,6.152488619459189,7.414243980271627,4.164160555024645,13,30,21,21,5,5,9,8,80,63,76,75,8,25,12,13,7,7,3,4
280,0.3,0.8181818181818182,0.8,0.9285714285714286,1.0,3.5110893278004554,5.078074471710978,6.8317063871077215,3.747156830588836,11,15,14,33,5,0,0,5,82,73,74,60,6,15,14,28,7,12,12,7
281,0.3,0.75,0.9318181818181818,1.0,0.8947368421052632,3.7980350672237377,6.2486479522060785,7.00642804639071,4.031041402743313,12,44,12,19,9,9,12,9,85,53,88,78,3,35,0,10,3,3,0,3
282,0.3,0.8421052631578947,0.9473684210526315,0.8695652173913043,0.9545454545454546,3.498353280946804,4.92865841031623,6.381491989807432,3.6451819425182417,19,19,23,22,9,5,9,12,78,74,74,78,10,14,14,10,3,7,3,0
283,0.3,0.8235294117647058,0.8636363636363636,0.7692307692307693,0.7333333333333333,3.751863710605232,5.5640412338154475,6.517538636937702,3.965502290557945,17,22,13,45,7,4,3,12,78,70,78,55,10,18,10,33,5,8,9,0
284,0.3,0.625,0.8461538461538461,1.0,0.875,3.673024518955266,5.329925680869137,6.674500551906696,4.309003925198941,8,13,5,8,4,4,0,4,84,79,83,84,4,9,5,4,8,8,12,8
285,0.3,0.9166666666666666,0.8947368421052632,0.9090909090909091,0.9130434782608695,3.750376942758784,5.90691333541655,7.576121478833174,3.887436788765746,12,19,22,23,4,5,4,4,80,74,70,69,8,14,18,19,8,7,8,8
286,0.3,0.75,1.0,0.5,0.9166666666666666,3.5747173321178844,4.850327954695291,5.8778715096601815,3.9138992590865542,8,5,4,24,0,0,0,5,80,83,84,69,8,5,4,19,12,12,12,7
287,0.3,0.9333333333333333,0.84375,0.9333333333333333,0.8444444444444444,3.687612693247383,5.291922122408897,7.150854248280759,3.856265670273209,15,32,30,45,5,8,12,12,78,64,70,55,10,24,18,33,7,4,0,0
288,0.3,0.8888888888888888,0.8636363636363636,1.0,0.8888888888888888,3.6107822028086716,5.1424393078275275,7.098482463456318,3.8216606186389956,9,22,9,18,9,9,9,8,88,75,88,78,0,13,0,10,3,3,3,4
289,0.3,0.8421052631578947,0.9666666666666667,0.8695652173913043,0.9722222222222222,3.7476084456523555,5.775553570717481,6.827100070113284,3.948732633214927,19,30,23,36,9,12,9,9,78,70,74,61,10,18,14,27,3,0,3,3
290,0.3,0.84375,0.9459459459459459,0.7777777777777778,0.9285714285714286,3.8301132944707184,6.111659714186219,6.49334201287389,3.962640962382211,32,37,9,42,9,9,9,9,65,60,88,55,23,28,0,33,3,3,3,3
291,0.3,0.6956521739130435,0.9047619047619048,0.8620689655172413,0.9393939393939394,3.576391482831138,5.646717261530521,6.702935792247685,3.839771370235575,23,21,29,33,4,4,5,0,69,71,64,55,19,17,24,33,8,8,7,12
292,0.3,0.7692307692307693,0.9347826086956522,0.7777777777777778,0.9583333333333334,3.4723662118775134,5.409519653644874,6.308458656013337,3.656663510497154,13,46,18,48,8,8,8,8,83,50,78,48,5,38,10,40,4,4,4,4
293,0.3,0.8,0.8333333333333334,1.0,1.0,3.6045208243302986,5.089973511816147,6.454783069774008,4.306939297836689,5,6,10,12,5,3,5,8,88,85,83,84,0,3,5,4,7,9,7,4
294,0.3,0.5,0.8571428571428571,0.8947368421052632,1.0,3.7807376856148704,5.3233253125252045,7.266457756636221,4.2002723259463925,12,14,19,17,5,5,5,9,81,79,74,80,7,9,14,8,7,7,7,3
295,0.3,0.6666666666666666,0.8620689655172413,0.896551724137931,0.8409090909090909,3.5863534989980397,5.48172841802087,6.4506045404254175,3.6719993602728196,36,29,29,44,9,9,8,9,61,68,67,53,27,20,21,35,3,3,4,3
296,0.3,0.8260869565217391,0.8928571428571429,0.90625,0.896551724137931,3.6392239884046518,5.448050832747683,6.944311598218526,3.682877280672626,23,28,32,58,9,9,12,8,74,69,68,38,14,19,20,50,3,3,0,4
297,0.3,0.8888888888888888,0.875,0.9473684210526315,0.8648648648648649,3.4628169067820447,5.515979034611578,6.404995033328326,3.5890186121305097,9,40,19,37,9,7,4,4,88,55,73,55,0,33,15,33,3,5,8,8
298,0.3,0.7714285714285715,0.7419354838709677,0.7692307692307693,0.8888888888888888,3.799060992968718,5.441438951976682,6.432727941605592,3.80040134929176,35,31,26,27,7,5,3,4,60,62,65,65,28,26,23,23,5,7,9,8
299,0.3,0.6923076923076923,0.7777777777777778,1.0,0.8974358974358975,3.727321154044028,5.094014328450163,7.237819630637631,4.186162392543931,13,9,20,39,9,5,5,8,84,84,73,57,4,4,15,31,3,7,7,4
300,0.4,0.75,0.8636363636363636,0.5833333333333334,0.9130434782608695,3.6823533528891774,5.626232827490981,7.07920411855534,3.9005462437432685,16,22,12,46,9,4,5,5,81,70,81,47,7,18,7,41,3,8,7,7
301,0.4,0.8421052631578947,0.9130434782608695,0.8333333333333334,0.9696969696969697,3.6835102498989487,5.586048061570966,6.595337875414297,3.9153232894199896,19,23,24,33,9,9,9,9,78,74,73,64,10,14,15,24,3,3,3,3
302,0.4,0.8,0.9473684210526315,0.85,1.0,3.6558729090698012,5.112296255573877,6.486336079926984,3.922962805755188,15,19,20,23,5,5,5,5,78,74,73,70,10,14,15,18,7,7,7,7
303,0.4,0.7777777777777778,1.0,0.9117647058823529,0.9310344827586207,3.6725785064215066,5.377424710225492,7.15631212103041,3.9357061828634325,18,13,34,29,5,9,9,5,75,84,63,64,13,4,25,24,7,3,3,7
304,0.4,0.9285714285714286,0.9285714285714286,0.7857142857142857,0.875,3.8432823647111465,5.624594715542905,6.7639811256565325,4.154905622035012,14,14,14,24,5,0,5,0,79,74,79,64,9,14,9,24,7,12,7,12
305,0.4,0.7647058823529411,0.95,0.8571428571428571,0.9166666666666666,3.841053781144442,6.163786015910762,7.333506717983753,4.128397607800914,17,40,14,12,12,5,9,9,83,53,83,85,5,35,5,3,0,7,3,3
306,0.4,0.7857142857142857,0.9166666666666666,0.8888888888888888,0.8571428571428571,3.711382913506294,5.69819797118026,6.575062106462655,3.8625531521342658,14,24,9,14,9,9,9,9,83,73,88,83,5,15,0,5,3,3,3,3
307,0.4,0.8275862068965517,0.8947368421052632,0.7142857142857143,0.9285714285714286,3.6650788783161414,4.888446717708881,6.492041197313797,3.774162203539473,29,19,14,14,5,5,5,5,64,74,79,79,24,14,9,9,7,7,7,7
308,0.4,0.8947368421052632,0.9444444444444444,0.8888888888888888,0.9230769230769231,3.607657588099446,5.218573800380245,7.2885354075294355,3.7631441670325003,19,18,9,26,9,3,9,12,78,73,88,74,10,15,0,14,3,9,3,0
309,0.4,0.7777777777777778,0.7142857142857143,0.8125,0.9230769230769231,3.7765243154374812,5.442788167710714,6.39680331291213,4.009586643133333,9,7,16,13,9,0,9,9,88,81,81,84,0,7,7,4,3,12,3,3
310,0.4,0.7857142857142857,0.9333333333333333,1.0,0.9032258064516129,3.661858406933583,5.40476662137154,6.3079815110525965,3.8221045798108504,14,15,4,31,9,0,4,9,83,73,88,66,5,15,0,22,3,12,8,3
311,0.4,0.8888888888888888,0.9230769230769231,1.0,0.8125,3.578367853014469,5.315977355513256,5.995425623448067,3.944220425017863,9,13,4,32,9,9,4,12,88,84,88,68,0,4,0,20,3,3,8,0
312,0.4,0.88,0.9545454545454546,0.8333333333333334,1.0,3.7354942260477753,5.820154795822129,7.098607795562779,4.011506029352907,25,44,24,36,8,12,5,9,71,56,69,61,17,32,19,27,4,0,7,3
313,0.4,0.8666666666666667,0.75,1.0,0.95,3.768880524928724,5.558518992195514,7.970065735121221,3.961766510860296,15,16,35,40,0,0,3,7,73,72,56,55,15,16,32,33,12,12,9,5
314,0.4,0.6923076923076923,0.8888888888888888,0.8518518518518519,0.8666666666666667,3.7487829896865033,5.519808157109458,7.443231327310651,4.079117248020262,13,36,27,30,5,5,5,5,80,57,66,63,8,31,22,25,7,7,7,7
315,0.4,0.8333333333333334,0.896551724137931,0.9473684210526315,0.8888888888888888,3.6969596106363216,5.804566639405996,6.389785919553563,3.876612926813723,12,29,19,36,5,9,5,5,81,68,74,57,7,20,14,31,7,3,7,7
316,0.4,1.0,0.9411764705882353,1.0,0.875,3.8161120751064184,5.4967131495582455,6.922402003263554,4.194269630418434,8,17,5,40,5,9,5,9,85,80,88,57,3,8,0,31,7,3,7,3
317,0.4,0.6666666666666666,0.9333333333333333,1.0,0.9230769230769231,3.573794772001748,5.097016648263383,6.833830082129795,3.9308904054163687,9,15,4,13,0,0,0,0,79,73,84,75,9,15,4,13,12,12,12,12
318,0.4,0.9333333333333333,0.8947368421052632,0.85,0.9642857142857143,3.6677614008506967,5.940483993036179,7.040038972958932,3.9062828760518937,15,38,20,28,5,5,5,5,78,55,73,65,10,33,15,23,7,7,7,7
319,0.4,1.0,0.84,0.92,1.0,3.646519425782853,5.522856367006991,7.122671062130425,3.786404343669493,13,25,25,23,5,5,8,5,80,68,71,70,8,20,17,18,7,7,4,7
320,0.4,0.8,1.0,0.9,0.8918918918918919,3.5000735460267474,5.149774463768644,5.966519316933908,3.516061185310149,15,16,20,37,5,8,5,8,78,80,73,59,10,8,15,29,7,4,7,4
321,0.4,0.75,1.0,1.0,0.8571428571428571,3.733614314575844,5.562119113161025,6.464957486682813,3.96705930747313,8,3,3,28,8,3,3,8,88,88,88,68,0,0,0,20,4,9,9,4
322,0.4,0.8285714285714286,0.8421052631578947,0.9444444444444444,0.84,3.7540600484690603,5.3756238176455104,7.1672233379178705,3.731364798528816,35,19,54,50,9,8,8,12,62,77,42,50,26,11,46,38,3,4,4,0
323,0.4,0.8888888888888888,0.8421052631578947,1.0,0.9642857142857143,3.7950421333297237,5.5285881581017,6.911554597282224,4.114757067494584,9,19,10,28,5,5,5,5,84,74,83,65,4,14,5,23,7,7,7,7
324,0.4,0.9,1.0,0.8,0.9387755102040817,3.748430901152054,5.237585790894028,6.954613521938507,4.1445351615026205,10,12,30,49,5,9,5,12,83,85,63,51,5,3,25,37,7,3,7,0
325,0.4,0.9473684210526315,0.96,0.9545454545454546,1.0,3.7563154086895167,5.72165358399851,6.842832001674425,3.870506919300205,19,25,22,33,5,9,9,9,74,72,75,64,14,16,13,24,7,3,3,3
326,0.4,0.9090909090909091,0.8888888888888888,1.0,0.9333333333333333,3.8173529509010433,5.154752095000084,7.595652186017293,4.16167298414349,11,9,4,30,8,5,0,8,85,84,84,66,3,4,4,22,4,7,12,4
327,0.4,0.84375,0.9473684210526315,0.9130434782608695,0.8846153846153846,3.609979309047615,5.437315784472312,6.9117927655452025,3.7327100799126294,32,38,23,52,5,0,5,5,61,50,70,41,27,38,18,47,7,12,7,7
328,0.4,1.0,1.0,1.0,0.8421052631578947,3.5242759254057328,5.863350383110092,6.0259844134850225,4.113662097817465,5,29,11,19,5,5,8,5,88,64,85,74,0,24,3,14,7,7,4,7
329,0.4,0.8571428571428571,0.8717948717948718,0.8888888888888888,0.9230769230769231,3.5860721103775886,6.012143875351578,6.191978796814773,4.01503036416262,14,39,9,13,5,5,9,5,79,54,88,80,9,34,0,8,7,7,3,7
330,0.4,0.9,0.9,0.96,0.92,3.5598678813756024,5.4327784503097,7.255098607622834,3.712145497404754,10,20,25,25,5,5,5,5,83,73,68,68,5,15,20,20,7,7,7,7
331,0.4,0.6666666666666666,0.8421052631578947,0.8888888888888888,0.8076923076923077,3.710145912400746,5.448691708882721,6.982936849247576,3.9119969596862014,18,19,18,26,3,4,3,7,73,73,73,69,15,15,15,19,9,8,9,5
332,0.4,0.7878787878787878,0.9130434782608695,0.967741935483871,0.8732394366197183,3.8211561459375103,5.477807887390019,7.225241511607196,3.9007222179471652,33,46,31,71,9,9,5,9,64,51,62,26,24,37,26,62,3,3,7,3
333,0.4,0.75,1.0,0.875,0.92,3.5401895649023967,5.409004852051816,6.195085520485346,3.982916563949711,8,18,8,25,8,8,8,8,88,78,88,71,0,10,0,17,4,4,4,4
334,0.4,0.75,0.8571428571428571,0.875,0.875,3.612142691727373,5.494535639919899,6.995478120123541,3.8302848923844195,28,21,24,24,9,5,9,9,69,72,73,73,19,16,15,15,3,7,3,3
335,0.4,0.8421052631578947,0.8947368421052632,0.7142857142857143,0.8636363636363636,3.7480925740582642,5.849362927951681,6.802212800515859,3.9460807686159454,19,38,14,22,9,9,4,12,78,59,78,78,10,29,10,10,3,3,8,0
336,0.4,0.875,0.9375,1.0,0.9090909090909091,3.7311366801851875,5.89732120188625,6.639464149569105,4.023042233948556,8,48,8,33,8,8,8,8,88,48,88,63,0,40,0,25,4,4,4,4
337,0.4,0.8260869565217391,0.8958333333333334,0.8947368421052632,1.0,3.7513218269593063,5.983516422163649,6.8833651295053855,4.014983383861414,23,48,19,33,9,12,9,9,74,52,78,64,14,36,10,24,3,0,3,3
338,0.4,0.5,0.7647058823529411,0.8387096774193549,0.8928571428571429,3.635592752611438,5.051299981709902,7.041699963456061,3.80184796793477,10,17,31,28,5,9,9,9,83,80,66,69,5,8,22,19,7,3,3,3
339,0.4,1.0,0.9230769230769231,0.8571428571428571,0.9583333333333334,3.991664060950066,6.203403789111915,6.7246591419414585,4.256707456143368,5,39,14,24,5,9,4,9,88,58,78,73,0,30,10,15,7,3,8,3
340,0.4,0.9166666666666666,0.8333333333333334,1.0,0.8888888888888888,3.6849848160803678,5.318407048730857,6.155472236572153,4.034687707287848,12,18,7,27,5,5,0,9,81,75,81,70,7,13,7,18,7,7,12,3
341,0.4,0.8888888888888888,0.9166666666666666,0.9333333333333333,0.9285714285714286,3.7073052026883166,5.601405343068645,6.505891188180857,3.9340479643639585,9,36,15,28,9,9,5,5,88,61,78,65,0,27,10,23,3,3,7,7
342,0.4,0.8947368421052632,0.8333333333333334,0.8928571428571429,1.0,3.7636131821056042,5.559908802166123,6.424968129913849,4.086237230444511,19,30,28,13,4,12,4,4,73,70,64,79,15,18,24,9,8,0,8,8
343,0.4,0.6666666666666666,0.9333333333333333,0.9333333333333333,0.9069767441860465,3.737855553403959,5.777081786864019,7.088552464157967,4.066263310553097,18,30,15,43,9,0,0,9,79,58,73,54,9,30,15,34,3,12,12,3
344,0.4,0.7368421052631579,0.8333333333333334,0.8148148148148148,0.8823529411764706,3.7324310401831484,5.798137659565951,7.007936975803041,4.061915375333234,19,36,27,51,4,9,9,9,73,61,70,46,15,27,18,42,8,3,3,3
345,0.4,0.7857142857142857,0.8666666666666667,0.8571428571428571,0.9019607843137255,3.9702455778078436,5.891057241602732,7.0220776484517105,4.1535278701085785,14,30,14,51,0,5,0,8,74,63,74,45,14,25,14,43,12,7,12,4
346,0.4,0.9333333333333333,0.9285714285714286,0.9473684210526315,0.9032258064516129,3.805514689247124,5.575232427118236,7.217985786868195,4.127892425037881,15,14,19,31,5,0,9,12,78,74,78,69,10,14,10,19,7,12,3,0
347,0.4,0.8888888888888888,0.9473684210526315,0.7857142857142857,0.9137931034482759,3.71382585600073,5.523327774706144,6.506689463605425,3.997839843091957,9,19,14,58,9,4,9,4,88,73,83,34,0,15,5,54,3,8,3,8
348,0.4,1.0,1.0,0.8,1.0,3.6471244668972838,5.063517028705722,6.208580795423259,4.056807777424093,5,10,5,18,5,5,5,5,88,83,88,75,0,5,0,13,7,7,7,7
349,0.4,0.8,0.9285714285714286,0.8,0.85,3.785549601634575,5.407879073147137,6.099766499815631,4.024472669165544,15,28,5,20,5,9,5,5,78,69,88,73,10,19,0,15,7,3,7,7
350,0.4,0.9166666666666666,0.8888888888888888,0.9655172413793104,0.9565217391304348,3.7774435772768498,5.3935903032205506,8.113811267044783,3.925203301234206,24,9,29,23,9,4,9,0,73,83,68,65,15,5,20,23,3,8,3,12
351,0.4,0.7777777777777778,0.8235294117647058,0.8,0.8723404255319149,3.8199036199351784,5.407680543560754,7.123685846596148,4.053961875424993,18,17,20,47,5,9,8,9,75,80,76,50,13,8,12,38,7,3,4,3
352,0.4,0.7931034482758621,0.8703703703703703,0.9318181818181818,0.8269230769230769,3.75225306968852,5.948971617145201,7.207121959342013,3.8263383808933877,29,54,44,52,9,8,9,9,68,42,53,45,20,46,35,43,3,4,3,3
353,0.4,0.7,0.9166666666666666,0.9285714285714286,0.9285714285714286,3.6319803154716537,5.248705454210718,6.7250918987010575,3.9508848055688586,10,24,14,14,5,9,9,5,83,73,83,79,5,15,5,9,7,3,3,7
354,0.4,0.7777777777777778,0.875,0.9,0.8,3.6603348381608702,5.38854627407396,7.19894533386864,3.9190699069435473,9,16,10,20,5,9,5,5,84,81,83,73,4,7,5,15,7,3,7,7
355,0.4,0.6,0.7142857142857143,0.8,0.90625,3.642797801684729,5.316374520277277,6.943722293582785,3.9548216815953467,10,14,10,32,0,0,0,7,78,74,78,63,10,14,10,25,12,12,12,5
356,0.4,1.0,0.9285714285714286,0.7777777777777778,0.9615384615384616,3.8966351427639068,6.025742637706321,6.945115287163255,4.393500342871111,5,28,9,26,5,8,5,5,88,68,84,67,0,20,4,21,7,4,7,7
357,0.4,0.7777777777777778,0.9523809523809523,0.8846153846153846,0.8157894736842105,3.5630521428542727,4.984183129899882,6.589351560798412,3.9183292025624596,18,21,26,38,0,12,8,12,70,79,70,62,18,9,18,26,12,0,4,0
358,0.4,0.875,0.8974358974358975,0.8571428571428571,0.9705882352941176,3.4684647467424,5.581114953311142,6.126238242333942,3.4925630717076634,24,39,28,34,9,9,9,9,73,58,69,63,15,30,19,25,3,3,3,3
359,0.4,0.8235294117647058,0.875,0.8823529411764706,1.0,3.5823471753441245,5.599560326964877,6.801779158296004,3.8971387940525166,17,40,17,34,8,3,8,5,79,51,79,59,9,37,9,29,4,9,4,7
360,0.4,0.9,0.8529411764705882,1.0,0.9117647058823529,3.4813198548590547,5.236449590226503,6.90311796776507,3.6087944749005634,10,34,9,34,5,9,5,5,83,63,84,59,5,25,4,29,7,3,7,7
361,0.4,0.9090909090909091,0.8947368421052632,1.0,0.9285714285714286,3.6900190646721116,5.257254189968162,6.857751067608245,4.017286610622009,11,19,11,14,5,12,5,8,82,81,82,82,6,7,6,6,7,0,7,4
362,0.4,0.9166666666666666,0.7647058823529411,1.0,0.85,3.809062353927699,5.971509352780921,7.338081034014115,4.270721686294791,12,17,8,20,9,9,5,12,85,80,85,80,3,8,3,8,3,3,7,0
363,0.4,0.8846153846153846,1.0,0.9047619047619048,0.9285714285714286,3.670885265162668,5.359938636158828,6.285122546901531,3.8737797872001196,26,30,21,42,5,5,5,5,67,63,72,51,21,25,16,37,7,7,7,7
364,0.4,0.8888888888888888,0.75,1.0,0.8571428571428571,3.7849396705652043,5.26045250482743,7.4658913973678755,3.923672210419578,9,8,11,14,9,5,8,9,88,85,85,83,0,3,3,5,3,7,4,3
365,0.4,0.875,0.8,0.7391304347826086,0.9310344827586207,3.759156373755216,5.326758344650818,6.660569197613579,4.218815083781022,8,5,23,29,8,5,5,5,88,88,70,64,0,0,18,24,4,7,7,7
366,0.4,0.7142857142857143,1.0,1.0,1.0,3.6946778289923303,5.368891576051146,7.326173442593995,4.063005670497194,14,9,22,18,9,4,12,4,83,83,78,74,5,5,10,14,3,8,0,8
367,0.4,0.8571428571428571,0.9333333333333333,1.0,0.9655172413793104,3.952487274849153,5.911483356199012,7.074434130207358,4.324730726152523,21,15,10,29,5,5,5,5,72,78,83,64,16,10,5,24,7,7,7,7
368,0.4,0.7777777777777778,0.9629629629629629,1.0,0.967741935483871,3.646362361703254,5.425020333985215,6.401031179177287,3.958413364108652,9,27,15,31,5,5,5,9,84,66,78,66,4,22,10,22,7,7,7,3
369,0.4,,0.6666666666666666,0.8,1.0,,5.750676737026425,6.816090459184837,4.851940728908473,0,9,5,7,0,0,5,3,88,79,88,84,0,9,0,4,12,12,7,9
370,0.4,0.8888888888888888,0.7777777777777778,1.0,0.92,3.7118589042189822,5.347216735963277,6.731813888255422,4.192880481603694,9,9,5,25,5,4,5,5,84,83,88,68,4,5,0,20,7,8,7,7
371,0.4,0.8181818181818182,0.9047619047619048,0.8461538461538461,0.8888888888888888,3.8799375530936184,5.608490552815603,7.246930312279459,4.014813587599924,22,21,13,27,9,9,9,9,75,76,84,70,13,12,4,18,3,3,3,3
372,0.4,0.8666666666666667,0.9565217391304348,1.0,0.96,3.728099822603541,5.781765617919325,6.812491517694585,4.185280502164298,15,23,5,25,0,4,5,5,73,69,88,68,15,19,0,20,12,8,7,7
373,0.4,0.9,0.9047619047619048,1.0,0.9642857142857143,3.7456516532248214,5.2153282387376425,6.944532230090512,3.957966803010511,10,21,5,28,5,8,5,5,83,75,88,65,5,13,0,23,7,4,7,7
374,0.4,0.7777777777777778,0.9230769230769231,0.7777777777777778,1.0,3.4831924408391948,4.94903153441552,5.854373904064044,3.7927789915467156,9,13,9,36,9,9,9,12,88,84,88,64,0,4,0,24,3,3,3,0
375,0.4,1.0,0.90625,0.75,0.9473684210526315,3.7191121037808754,6.0532793752622975,6.385157907770392,4.040506640535065,4,32,8,19,0,4,0,5,84,60,80,74,4,28,8,14,12,8,12,7
376,0.4,1.0,1.0,0.9629629629629629,0.9375,3.52754318348619,5.2812774493611725,7.195199826278783,3.8637939506218912,9,15,27,48,9,0,7,9,88,73,68,49,0,15,20,39,3,12,5,3
377,0.4,0.7058823529411765,0.9032258064516129,1.0,0.8823529411764706,3.5758482707817087,5.565112204511775,7.155383567726409,4.13883750279499,17,31,15,34,5,9,5,8,76,66,78,62,12,22,10,26,7,3,7,4
378,0.4,0.9230769230769231,0.9333333333333333,0.9230769230769231,0.9333333333333333,3.4481473845141184,5.1628963713986655,5.571855982460317,3.6976746971946466,13,15,13,30,5,5,5,9,80,78,80,67,8,10,8,21,7,7,7,3
379,0.4,0.5882352941176471,0.9666666666666667,0.7083333333333334,0.8571428571428571,3.9201210969648685,6.15990337958537,7.444341282712294,4.150591777316924,17,30,24,21,9,5,12,8,80,63,76,75,8,25,12,13,3,7,0,4
380,0.4,0.8181818181818182,0.85,0.9285714285714286,1.0,3.515275560559978,5.133004176686105,6.8892914376000585,3.7437284696832998,11,20,14,33,5,5,0,5,82,73,74,60,6,15,14,28,7,7,12,7
381,0.4,0.75,0.9318181818181818,1.0,0.9473684210526315,3.7978049212454916,6.247592702740774,7.00642804639071,3.966843954264719,12,44,12,19,9,9,12,9,85,53,88,78,3,35,0,10,3,3,0,3
382,0.4,0.8421052631578947,0.9473684210526315,0.8695652173913043,0.9545454545454546,3.4976337219598217,4.933342367429089,6.381968183631022,3.6430429284442813,19,19,23,22,9,5,9,12,78,74,74,78,10,14,14,10,3,7,3,0
383,0.4,0.8636363636363636,0.8636363636363636,0.7692307692307693,0.8666666666666667,3.758155698402511,5.581611570024957,6.5428936880728,3.950488823614964,22,22,13,45,12,4,3,12,78,70,78,55,10,18,10,33,0,8,9,0
384,0.4,0.6923076923076923,0.8461538461538461,1.0,0.875,3.644720774134224,5.34850018297074,6.710928521222722,4.287246712431426,13,13,5,8,9,4,0,4,84,79,83,84,4,9,5,4,3,8,12,8
385,0.4,0.9166666666666666,0.8947368421052632,0.9629629629629629,0.9565217391304348,3.7582436456006953,5.9138753639975095,7.805473186724759,3.8732217510472595,12,19,27,23,4,5,9,4,80,74,70,69,8,14,18,19,8,7,3,8
386,0.4,0.75,1.0,0.5,0.875,3.5821180943832007,4.855039231086977,5.8850856644800285,3.898177967317416,8,5,4,24,0,0,0,5,80,83,84,69,8,5,4,19,12,12,12,7
387,0.4,0.9333333333333333,0.84375,0.9333333333333333,0.8444444444444444,3.6877559736509578,5.288493437043366,7.150854248280759,3.8630547677956777,15,32,30,45,5,8,12,12,78,64,70,55,10,24,18,33,7,4,0,0
388,0.4,0.8888888888888888,0.8636363636363636,1.0,0.8888888888888888,3.6110989056216827,5.142503446761311,7.098455106483154,3.8192579676942677,9,22,9,18,9,9,9,8,88,75,88,78,0,13,0,10,3,3,3,4
389,0.4,0.8421052631578947,0.9666666666666667,0.8695652173913043,0.9444444444444444,3.7488657652818005,5.775553570717481,6.829205367904632,3.931002731786835,19,30,23,36,9,12,9,9,78,70,74,61,10,18,14,27,3,0,3,3
390,0.4,0.84375,0.9459459459459459,0.7777777777777778,0.875,3.8301082083113043,6.1111053514170015,6.49418600183333,4.091233199758887,32,37,9,32,9,9,9,9,65,60,88,65,23,28,0,23,3,3,3,3
391,0.4,0.7142857142857143,0.9230769230769231,0.8620689655172413,0.868421052631579,3.593158163629238,5.635116952018793,6.720348216940109,3.7434479862958865,28,26,29,38,9,9,5,5,69,71,64,55,19,17,24,33,3,3,7,7
392,0.4,0.7692307692307693,0.9347826086956522,0.7777777777777778,0.9583333333333334,3.472526082731532,5.4151719627545845,6.318879500281155,3.6482245042637937,13,46,18,48,8,8,8,8,83,50,78,48,5,38,10,40,4,4,4,4
393,0.4,0.8,0.9090909090909091,1.0,1.0,3.605770312283142,5.209216733990775,6.459939723342755,4.172288237808221,5,11,10,9,5,8,5,5,88,85,83,84,0,3,5,4,7,4,7,7
394,0.4,0.5,0.8571428571428571,0.8947368421052632,0.9411764705882353,3.783417454347284,5.332598127549202,7.27398204576897,4.224703766866946,12,14,19,17,5,5,5,9,81,79,74,80,7,9,14,8,7,7,7,3
395,0.4,0.6666666666666666,0.8620689655172413,0.8787878787878788,0.8409090909090909,3.5869933352819015,5.483432882394518,6.545722184081833,3.662968280787581,36,29,33,44,9,9,12,9,61,68,67,53,27,20,21,35,3,3,0,3
396,0.4,0.8461538461538461,0.8928571428571429,0.90625,0.9193548387096774,3.637350683044413,5.451155692366348,6.944311598218526,3.928695035063673,26,28,32,62,12,9,12,12,74,69,68,38,14,19,20,50,0,3,0,0
397,0.4,0.8888888888888888,0.875,0.9473684210526315,0.8648648648648649,3.4623719096831382,5.533955218962598,6.412549254860577,3.5887969981414116,9,40,19,37,9,7,4,4,88,55,73,55,0,33,15,33,3,5,8,8
398,0.4,0.7714285714285715,0.7419354838709677,0.7647058823529411,0.8888888888888888,3.8035754111911713,5.454416301402737,6.6986016387932885,3.7952782326436028,35,31,34,27,7,5,7,4,60,62,61,65,28,26,27,23,5,7,5,8
399,0.4,0.6923076923076923,0.7777777777777778,1.0,0.9069767441860465,3.727436200630896,5.098911202635349,7.255592575305409,4.198636937086804,13,9,20,43,9,5,5,12,84,84,73,57,4,4,15,31,3,7,7,0
400,0.5,0.75,0.8518518518518519,0.5833333333333334,0.9,3.6824712553675423,5.600330070361731,7.095696191917935,3.86768193015427,16,27,12,50,9,9,5,9,81,70,81,47,7,18,7,41,3,3,7,3
401,0.5,0.7391304347826086,0.9130434782608695,0.8333333333333334,0.9393939393939394,3.6770662980841817,5.585733125156331,6.593566058678456,3.7063263236166453,23,23,24,33,9,9,9,9,74,74,73,64,14,14,15,24,3,3,3,3
402,0.5,0.8,0.9473684210526315,0.8666666666666667,1.0,3.658126469533341,5.1185986688714165,6.428118638328032,3.9228847250383723,15,19,15,23,5,5,5,5,78,74,78,70,10,14,10,18,7,7,7,7
403,0.5,0.8636363636363636,1.0,0.9117647058823529,0.9310344827586207,3.675393169493533,5.379411771290434,7.156460444012749,4.022372745498436,22,13,34,29,5,9,9,5,71,84,63,64,17,4,25,24,7,3,3,7
404,0.5,0.9285714285714286,0.9285714285714286,0.7857142857142857,0.875,3.845939364270429,5.644317483954496,6.7708707634035745,4.154461498135301,14,14,14,24,5,0,5,0,79,74,79,64,9,14,9,24,7,12,7,12
405,0.5,0.7647058823529411,0.95,0.8571428571428571,1.0,3.841053781144441,6.179442400304266,7.332863526970704,4.091167751634705,17,40,14,12,12,5,9,9,83,53,83,85,5,35,5,3,0,7,3,3
406,0.5,0.7857142857142857,0.9166666666666666,0.8888888888888888,0.9285714285714286,3.711671020337092,5.699101154089916,6.57379326603932,3.846888488773606,14,24,9,14,9,9,9,9,83,73,88,83,5,15,0,5,3,3,3,3
407,0.5,0.8275862068965517,0.8947368421052632,0.7142857142857143,0.9285714285714286,3.6680342196297286,4.8942472419750205,6.498150765311528,3.7010292262290574,29,19,14,14,5,5,5,5,64,74,79,79,24,14,9,9,7,7,7,7
408,0.5,0.9090909090909091,0.9565217391304348,0.8888888888888888,0.9230769230769231,3.6192219483547605,5.264690732358515,7.290366725635222,3.7413433330314727,22,23,9,26,12,8,9,12,78,73,88,74,10,15,0,14,0,4,3,0
409,0.5,0.7777777777777778,0.7142857142857143,0.7894736842105263,0.9230769230769231,3.776743453272163,5.4629365610249545,6.55399523123166,4.002312157633474,9,7,19,13,9,0,9,9,88,81,78,84,0,7,10,4,3,12,3,3
410,0.5,0.7857142857142857,0.9333333333333333,1.0,0.967741935483871,3.662258324262573,5.427336592245206,6.31912860410847,4.052959691613931,14,15,4,31,9,0,4,9,83,73,88,66,5,15,0,22,3,12,8,3
411,0.5,0.8888888888888888,0.9230769230769231,1.0,0.84375,3.5786965411414378,5.317067013307817,6.016572734505923,3.8781311077651153,9,13,4,32,9,9,4,12,88,84,88,68,0,4,0,20,3,3,8,0
412,0.5,0.896551724137931,0.9545454545454546,0.8333333333333334,1.0,3.735511958418476,5.820154795822129,7.110366496121819,4.002333943815932,29,44,24,36,12,12,5,9,71,56,69,61,17,32,19,27,0,0,7,3
413,0.5,0.88,0.75,1.0,0.8888888888888888,3.8467518483967105,5.5734870874304105,8.219235918930305,4.162335514174148,25,16,40,45,0,0,8,12,63,72,56,55,25,16,32,33,12,12,4,0
414,0.5,0.6923076923076923,0.8888888888888888,0.8518518518518519,0.8666666666666667,3.7507964036259263,5.524788166785391,7.446593128561936,4.071022302619004,13,36,27,30,5,5,5,5,80,57,66,63,8,31,22,25,7,7,7,7
415,0.5,0.8333333333333334,0.896551724137931,0.9473684210526315,0.8888888888888888,3.6993743153407537,5.804648432799985,6.400850159064991,3.8653960066115607,12,29,19,36,5,9,5,5,81,68,74,57,7,20,14,31,7,3,7,7
416,0.5,1.0,1.0,0.7777777777777778,0.85,3.817932781058528,5.4098957146198074,7.041617240279818,4.143171697376556,8,12,9,40,5,9,9,9,85,85,88,57,3,3,0,31,7,3,3,3
417,0.5,0.6666666666666666,0.9333333333333333,1.0,0.9230769230769231,3.577079415224384,5.10877125103904,6.840545460288099,3.929117662481464,9,15,9,13,0,0,0,0,79,73,79,75,9,15,9,13,12,12,12,12
418,0.5,0.9333333333333333,0.8947368421052632,0.85,0.9285714285714286,3.6707908768833377,5.94557886658666,7.051926390038323,3.8941405325195504,15,38,20,28,5,5,5,5,78,55,73,65,10,33,15,23,7,7,7,7
419,0.5,1.0,0.8620689655172413,0.9310344827586207,1.0,3.6584160773743624,5.571647304762449,7.297553860226645,3.781085030055227,17,29,29,23,9,9,12,5,80,68,71,70,8,20,17,18,3,3,0,7
420,0.5,0.8,1.0,0.9,0.8918918918918919,3.501647653140895,5.155042757488657,5.972367773245958,3.6182735391155503,15,16,20,37,5,8,5,8,78,80,73,59,10,8,15,29,7,4,7,4
421,0.5,0.75,0.875,1.0,0.7857142857142857,3.7355461724998826,5.602102234022059,6.497868650993333,3.9822088423978843,8,8,3,28,8,8,3,8,88,88,88,68,0,0,0,20,4,4,9,4
422,0.5,0.8285714285714286,0.8695652173913043,0.9444444444444444,0.84,3.7546436783858206,5.463041008536842,7.186023526490777,3.7250996856136296,35,23,54,50,9,12,8,12,62,77,42,50,26,11,46,38,3,0,4,0
423,0.5,0.8888888888888888,0.8421052631578947,1.0,0.9354838709677419,3.7982087010173995,5.531699816710976,6.922068716835869,4.177955044439666,9,19,10,31,5,5,5,8,84,74,83,65,4,14,5,23,7,7,7,4
424,0.5,0.9,1.0,0.8,0.9387755102040817,3.7519631263448416,5.2386693910844455,6.9573364686960115,4.12805709514635,10,12,30,49,5,9,5,12,83,85,63,51,5,3,25,37,7,3,7,0
425,0.5,0.9565217391304348,0.9545454545454546,0.9545454545454546,0.9696969696969697,3.7334399064930928,5.603880094414506,6.843289843638463,3.8594820064563087,23,22,22,33,9,9,9,9,74,75,75,64,14,13,13,24,3,3,3,3
426,0.5,0.9090909090909091,0.9166666666666666,1.0,0.8666666666666667,3.8181540048106415,5.157932493526172,7.645384846299159,4.095951387959202,11,12,4,30,8,8,0,8,85,84,84,66,3,4,4,22,4,4,12,4
427,0.5,0.84375,0.9302325581395349,0.9130434782608695,0.8846153846153846,3.611491626324255,5.414716313921467,6.914610016313424,3.73030598511836,32,43,23,52,5,5,5,5,61,50,70,41,27,38,18,47,7,7,7,7
428,0.5,1.0,1.0,1.0,0.8421052631578947,3.526985052411206,5.87423900552209,6.025044034780327,4.104545445256735,5,29,11,19,5,5,8,5,88,64,85,74,0,24,3,14,7,7,4,7
429,0.5,0.8571428571428571,0.8717948717948718,0.8888888888888888,0.9230769230769231,3.589018607055592,6.016624967706029,6.193801170759928,4.007857696511321,14,39,9,13,5,5,9,5,79,54,88,80,9,34,0,8,7,7,3,7
430,0.5,0.9333333333333333,0.9,0.96,0.8620689655172413,3.617306495326277,5.434044622559376,7.2657351328343305,3.8394002774493714,15,20,25,29,5,5,5,9,78,73,68,68,10,15,20,20,7,7,7,3
431,0.5,0.6521739130434783,0.8421052631578947,0.8888888888888888,0.8076923076923077,3.6984444468412883,5.459955511052738,7.000610773096055,3.908248976556201,23,19,18,26,8,4,3,7,73,73,73,69,15,15,15,19,4,8,9,5
432,0.5,0.8108108108108109,0.9130434782608695,0.967741935483871,0.8732394366197183,3.8340930298032077,5.4773089649920434,7.231570563170561,3.897954761837139,37,46,31,71,9,9,5,9,60,51,62,26,28,37,26,62,3,3,7,3
433,0.5,0.75,1.0,0.9166666666666666,0.96,3.541506260887454,5.413229232582615,6.131474629959183,3.766350802753587,8,18,12,25,8,8,12,8,88,78,88,71,0,10,0,17,4,4,0,4
434,0.5,0.75,0.8571428571428571,0.875,0.7916666666666666,3.612022612961202,5.5027114530895735,6.995515785221102,3.7892765693418773,28,21,24,24,9,5,9,9,69,72,73,73,19,16,15,15,3,7,3,3
435,0.5,0.8421052631578947,0.8947368421052632,0.7368421052631579,0.9090909090909091,3.7483415756343006,5.850265638266815,6.593067087206997,4.043747339120474,19,38,19,22,9,9,9,12,78,59,78,78,10,29,10,10,3,3,3,0
436,0.5,0.875,0.9375,1.0,0.8928571428571429,3.7342342370317354,5.900343311575924,6.643441415433604,3.8424295056675377,8,48,8,28,8,8,8,8,88,48,88,68,0,40,0,20,4,4,4,4
437,0.5,0.8260869565217391,0.8958333333333334,0.8947368421052632,0.9696969696969697,3.7517735640706498,5.983516422163649,6.885005340486795,4.049638704186023,23,48,19,33,9,12,9,9,74,52,78,64,14,36,10,24,3,0,3,3
438,0.5,0.6428571428571429,0.7647058823529411,0.8387096774193549,0.8928571428571429,3.6202551068967534,5.051820228349274,7.039535056043678,3.795892788277731,14,17,31,28,9,9,9,9,83,80,66,69,5,8,22,19,3,3,3,3
439,0.5,1.0,0.9230769230769231,0.8421052631578947,0.9411764705882353,3.9963531787565634,6.203951449033503,6.820949221672258,4.256473348617413,5,39,19,34,5,9,9,9,88,58,78,63,0,30,10,25,7,3,3,3
440,0.5,0.9166666666666666,0.8333333333333334,0.9166666666666666,0.9629629629629629,3.6874547453538207,5.324825166647911,6.253616983482385,4.10294671393543,12,18,12,27,5,5,5,9,81,75,81,70,7,13,7,18,7,7,7,3
441,0.5,0.8888888888888888,0.9166666666666666,0.9333333333333333,0.9285714285714286,3.7083871229271685,5.604491752472457,6.526981520554314,3.9302358636334804,9,36,15,28,9,9,5,5,88,61,78,65,0,27,10,23,3,3,7,7
442,0.5,0.8947368421052632,0.8333333333333334,0.8928571428571429,1.0,3.770092305461619,5.559908802166123,6.441563954874498,4.082187086271052,19,30,28,13,4,12,4,4,73,70,64,79,15,18,24,9,8,0,8,8
443,0.5,0.6666666666666666,0.9333333333333333,0.9,0.9534883720930233,3.737326865908975,5.790853397680505,7.104965798407082,4.0594902646536575,18,30,20,43,9,0,5,9,79,58,73,54,9,30,15,34,3,12,7,3
444,0.5,0.75,0.8333333333333334,0.8148148148148148,0.8431372549019608,3.765144820274586,5.799929842500995,7.01082661797145,3.9834872079635635,24,36,27,51,9,9,9,9,73,61,70,46,15,27,18,42,3,3,3,3
445,0.5,0.8421052631578947,0.8666666666666667,0.8571428571428571,0.9019607843137255,3.996519761709885,5.898236047900458,7.045443816654054,4.142945122631962,19,30,14,51,5,5,0,8,74,63,74,45,14,25,14,43,7,7,12,4
446,0.5,0.8421052631578947,0.8947368421052632,0.9473684210526315,0.9032258064516129,3.7944487587827407,5.5339269376183715,7.216291712136393,4.117216043576343,19,19,19,31,9,5,9,12,78,74,78,69,10,14,10,19,3,7,3,0
447,0.5,0.8888888888888888,1.0,0.6666666666666666,0.9047619047619048,3.714381455018778,5.517266319448102,6.370155783162225,3.9698246711318905,9,24,9,63,9,9,9,9,88,73,88,34,0,15,0,54,3,3,3,3
448,0.5,1.0,1.0,0.8,1.0,3.6474227018325203,5.06396536860454,6.2112141374301055,3.93063649958466,5,10,5,18,5,5,5,5,88,83,88,75,0,5,0,13,7,7,7,7
449,0.5,0.8,0.9285714285714286,0.8,0.85,3.7865828510576245,5.408203954438237,6.101752106880386,4.020842123426581,15,28,5,20,5,9,5,5,78,69,88,73,10,19,0,15,7,3,7,7
450,0.5,0.9166666666666666,0.7857142857142857,0.9655172413793104,0.9642857142857143,3.777922944335487,5.348636694286135,8.113676594317111,3.9557026404741498,24,14,29,28,9,9,9,5,73,83,68,65,15,5,20,23,3,3,3,7
451,0.5,0.7777777777777778,0.8235294117647058,0.8333333333333334,0.8723404255319149,3.823331615574037,5.409751352410044,7.215730246917135,3.9662167207750474,18,17,24,47,5,9,12,9,75,80,76,50,13,8,12,38,7,3,0,3
452,0.5,0.7931034482758621,0.8703703703703703,0.9318181818181818,0.8269230769230769,3.752358767158874,5.954310477810143,7.207788819746283,3.8216200687956676,29,54,44,52,9,8,9,9,68,42,53,45,20,46,35,43,3,4,3,3
453,0.5,0.7,0.9166666666666666,0.9285714285714286,1.0,3.633883733358258,5.2496358197911,6.725478030996757,3.979012138091839,10,24,14,14,5,9,9,5,83,73,83,79,5,15,5,9,7,3,3,7
454,0.5,0.8461538461538461,0.875,0.9,0.8,3.6380617471503647,5.389558229759255,7.2048465080496085,3.880920794624889,13,16,10,20,9,9,5,5,84,81,83,73,4,7,5,15,3,3,7,7
455,0.5,0.6,0.7894736842105263,0.8,0.918918918918919,3.6499378032780143,5.301145506593568,6.978040982066574,3.958815741113649,10,19,10,37,0,5,0,12,78,74,78,63,10,14,10,25,12,7,12,0
456,0.5,1.0,0.9285714285714286,0.7777777777777778,0.9615384615384616,3.895058471469717,6.033435972235985,6.950975252762182,4.387719540832438,9,28,9,26,9,8,5,5,88,68,84,67,0,20,4,21,3,4,7,7
457,0.5,0.782608695652174,0.9523809523809523,0.8846153846153846,0.8157894736842105,3.5881232925480817,4.984183129899882,6.593006466948738,3.909764660735996,23,21,26,38,8,12,8,12,73,79,70,62,15,9,18,26,4,0,4,0
458,0.5,0.875,0.8974358974358975,0.8571428571428571,0.9705882352941176,3.4679978726840517,5.580352076622817,6.12475227561547,3.4872448289220723,24,39,28,34,9,9,9,9,73,58,69,63,15,30,19,25,3,3,3,3
459,0.5,0.8235294117647058,0.8444444444444444,0.8823529411764706,1.0,3.583707624631057,5.685957295067812,6.809497683724409,3.8951343142967136,17,45,17,34,8,8,8,5,79,51,79,59,9,37,9,29,4,4,4,7
460,0.5,0.8571428571428571,0.8529411764705882,1.0,0.9117647058823529,3.4718340262363694,5.2356992788576,7.0211122200384795,3.6062743751271746,14,34,13,34,9,9,9,5,83,63,84,59,5,25,4,29,3,3,3,7
461,0.5,0.9090909090909091,0.8947368421052632,1.0,0.9285714285714286,3.689697499577902,5.257254189968161,6.85886672336347,4.132784311788735,11,19,11,14,5,12,5,8,82,81,82,82,6,7,6,6,7,0,7,4
462,0.5,0.9166666666666666,0.9090909090909091,1.0,0.85,3.8086722445463583,6.070885299536661,7.335811560101445,4.247443560259424,12,22,5,20,9,9,5,12,85,75,88,80,3,13,0,8,3,3,7,0
463,0.5,0.8846153846153846,0.9696969696969697,0.9047619047619048,0.9285714285714286,3.670783310913436,5.4502198786101355,6.293295439122659,3.8725706251581364,26,33,21,42,5,5,5,5,67,60,72,51,21,28,16,37,7,7,7,7
464,0.5,0.8888888888888888,0.75,0.9333333333333333,0.9285714285714286,3.7855954696703185,5.262314507991861,7.594766868265492,4.040128230888569,9,8,15,14,9,5,12,9,88,85,85,83,0,3,3,5,3,7,0,3
465,0.5,0.875,0.8,0.7391304347826086,0.9310344827586207,3.7607834903478112,5.330549264876197,6.66282653071262,4.217419948557552,8,5,23,29,8,5,5,5,88,88,70,64,0,0,18,24,4,7,7,7
466,0.5,0.7142857142857143,1.0,1.0,1.0,3.695401631473671,5.380690426935253,7.326173442593994,3.99907616557853,14,9,22,18,9,4,12,4,83,83,78,74,5,5,10,14,3,8,0,8
467,0.5,0.8571428571428571,0.9333333333333333,1.0,0.9655172413793104,3.95425283336284,5.911264374118116,7.075549449918855,4.259875354811032,21,15,10,29,5,5,5,5,72,78,83,64,16,10,5,24,7,7,7,7
468,0.5,0.7777777777777778,0.9629629629629629,1.0,0.9354838709677419,3.648674553158016,5.433798368139357,6.408637667311447,3.9991394459792713,9,27,15,31,5,5,5,9,84,66,78,66,4,22,10,22,7,7,7,3
469,0.5,,0.6666666666666666,0.8,1.0,,5.763168155496331,6.818629917457633,4.615708999743208,0,9,5,7,0,0,5,3,88,79,88,84,0,9,0,4,12,12,7,9
470,0.5,0.8888888888888888,0.7777777777777778,1.0,0.9655172413793104,3.7140671100241716,5.3631523741849465,6.739142489948833,4.045381783703444,9,9,5,29,5,4,5,9,84,83,88,68,4,5,0,20,7,8,7,3
471,0.5,0.8181818181818182,0.9615384615384616,0.8461538461538461,0.8888888888888888,3.8797103986271377,5.63326857388623,7.245716442240549,4.179846117586159,22,26,13,27,9,9,9,9,75,71,84,70,13,17,4,18,3,3,3,3
472,0.5,0.8666666666666667,0.9565217391304348,1.0,0.96,3.733804659804364,5.781933693475942,6.812335875280172,4.185285434339841,15,23,5,25,0,4,5,5,73,69,88,68,15,19,0,20,12,8,7,7
473,0.5,0.9,0.9047619047619048,1.0,0.9642857142857143,3.7465806418442327,5.213559058758409,6.94608056908599,3.9497678626201846,10,21,5,28,5,8,5,5,83,75,88,65,5,13,0,23,7,4,7,7
474,0.5,0.7777777777777778,0.9230769230769231,0.7777777777777778,0.9444444444444444,3.483508669928302,4.949214644917704,5.855350519072093,3.7772566106311865,9,13,9,36,9,9,9,12,88,84,88,64,0,4,0,24,3,3,3,0
475,0.5,1.0,0.918918918918919,0.75,0.9473684210526315,3.7265876946154974,6.144371907034581,6.408191639788582,4.037329378666959,4,37,8,19,0,9,0,5,84,60,80,74,4,28,8,14,12,3,12,7
476,0.5,1.0,0.95,0.9411764705882353,0.9583333333333334,3.5275868052158756,5.336408534594691,6.819382324209622,3.8560310916913125,9,20,17,48,9,5,7,9,88,73,78,49,0,15,10,39,3,7,5,3
477,0.5,0.7058823529411765,0.9032258064516129,1.0,0.918918918918919,3.577611041639084,5.565601653188291,7.298681921698255,3.877506851910205,17,31,19,37,5,9,9,8,76,66,78,59,12,22,10,29,7,3,3,4
478,0.5,0.9411764705882353,0.9333333333333333,0.9230769230769231,0.9333333333333333,3.4559537294121974,5.168695024042445,5.581873314233952,3.689945586479173,17,15,13,30,9,5,5,9,80,78,80,67,8,10,8,21,3,7,7,3
479,0.5,0.5882352941176471,0.9666666666666667,0.7083333333333334,0.8571428571428571,3.9207876025010497,6.16699255458523,7.444341282712294,4.137330358311097,17,30,24,21,9,5,12,8,80,63,76,75,8,25,12,13,3,7,0,4
480,0.5,0.8181818181818182,0.85,0.9473684210526315,0.918918918918919,3.519537703535796,5.141974046687252,6.974464177119763,3.8919888322870513,11,20,19,37,5,5,5,9,82,73,74,60,6,15,14,28,7,7,7,3
481,0.5,0.75,0.9259259259259259,1.0,0.9473684210526315,3.797625235502195,6.31750598379888,7.00642804639071,3.9449738272891084,12,54,12,19,9,9,12,9,85,43,88,78,3,45,0,10,3,3,0,3
482,0.5,0.8421052631578947,0.9473684210526315,0.8695652173913043,0.9545454545454546,3.4970504837229,4.937993823741622,6.382477275355847,3.869396179206129,19,19,23,22,9,5,9,12,78,74,74,78,10,14,14,10,3,7,3,0
483,0.5,0.8636363636363636,0.8636363636363636,0.7692307692307693,0.7555555555555555,3.758155698402511,5.598566265071003,6.568283053242036,3.9497088195078165,22,22,13,45,12,4,3,12,78,70,78,55,10,18,10,33,0,8,9,0
484,0.5,0.6923076923076923,0.8888888888888888,0.8888888888888888,0.7692307692307693,3.6445256224759977,5.30885314652619,6.666752230304324,4.022405327342334,13,18,9,13,9,9,4,9,84,79,83,84,4,9,5,4,3,3,8,3
485,0.5,0.9166666666666666,0.9130434782608695,0.9629629629629629,0.9565217391304348,3.7663945212831482,5.971702264374658,7.807649805949183,3.8590664014536826,12,23,27,23,4,9,9,4,80,74,70,69,8,14,18,19,8,3,3,8
486,0.5,0.75,0.9,0.5,0.875,3.5902796781958317,4.90147609748093,5.894445757436229,3.8897135327806063,8,10,4,24,0,5,0,5,80,83,84,69,8,5,4,19,12,7,12,7
487,0.5,0.9333333333333333,0.84375,0.9333333333333333,0.8444444444444444,3.6882655359040837,5.286017561029855,7.1508542482807576,3.8682520542953043,15,32,30,45,5,8,12,12,78,64,70,55,10,24,18,33,7,4,0,0
488,0.5,0.8888888888888888,0.8636363636363636,1.0,0.8888888888888888,3.6114084727367364,5.142603184894323,7.098481574199868,3.8176756837681847,9,22,9,18,9,9,9,8,88,75,88,78,0,13,0,10,3,3,3,4
489,0.5,0.8421052631578947,0.9666666666666667,0.8695652173913043,0.9444444444444444,3.7500070706241937,5.775553570717482,6.831112962394595,3.921598215619912,19,30,23,36,9,12,9,9,78,70,74,61,10,18,14,27,3,0,3,3
490,0.5,0.84375,0.9459459459459459,0.7777777777777778,0.875,3.8301341252564267,6.1106589300314385,6.494982244264809,4.08101653690686,32,37,9,32,9,9,9,9,65,60,88,65,23,28,0,23,3,3,3,3
491,0.5,0.7142857142857143,0.9230769230769231,0.875,0.8947368421052632,3.593853247178242,5.6372298567003565,6.85980252773974,3.798787588283237,28,26,32,38,9,9,8,5,69,71,64,55,19,17,24,33,3,3,4,7
492,0.5,0.7692307692307693,0.9347826086956522,0.7777777777777778,0.8958333333333334,3.4730234093248833,5.4206412235796515,6.328847841003807,3.6387258062234102,13,46,18,48,8,8,8,8,83,50,78,48,5,38,10,40,4,4,4,4
493,0.5,0.8,0.9090909090909091,1.0,1.0,3.607257387915017,5.212673363648462,6.465063001175963,4.158672597160536,5,11,10,9,5,8,5,5,88,85,83,84,0,3,5,4,7,4,7,7
494,0.5,0.5,0.8571428571428571,1.0,0.9411764705882353,3.786259986034338,5.3415654133977855,7.426283011710327,4.213185945350611,12,14,15,17,5,5,5,9,81,79,78,80,7,9,10,8,7,7,7,3
495,0.5,0.6666666666666666,0.8620689655172413,0.8787878787878788,0.8409090909090909,3.5875902082672844,5.484980564449362,6.545722184081834,3.6591108914712565,36,29,33,44,9,9,12,9,61,68,67,53,27,20,21,35,3,3,0,3
496,0.5,0.8461538461538461,0.8928571428571429,0.90625,0.9038461538461539,3.637350683044413,5.453934867397691,6.944311598218526,3.760832705817861,26,28,32,52,12,9,12,12,74,69,68,48,14,19,20,40,0,3,0,0
497,0.5,0.8888888888888888,0.8648648648648649,0.9583333333333334,0.8809523809523809,3.462006123445095,5.495324321978275,6.589133915112736,3.757279074229983,9,37,24,42,9,4,9,9,88,55,73,55,0,33,15,33,3,8,3,3
498,0.5,0.7714285714285715,0.7419354838709677,0.7647058823529411,0.8387096774193549,3.8084592310390137,5.466756987184643,6.703782673958485,3.8182621778264867,35,31,34,31,7,5,7,4,60,62,61,61,28,26,27,27,5,7,5,8
499,0.5,0.6923076923076923,0.8947368421052632,1.0,0.8837209302325582,3.7275819745154957,5.2131535620784915,7.2718650135271945,4.132073479669719,13,19,20,43,9,5,5,12,84,74,73,57,4,14,15,31,3,7,7,0
500,0.6,0.75,0.8518518518518519,0.5833333333333334,0.94,3.6825997897736387,5.6017956522755865,7.111371338175469,4.134279890491225,16,27,12,50,9,9,5,9,81,70,81,47,7,18,7,41,3,3,7,3
501,0.6,0.7391304347826086,0.9130434782608695,0.8333333333333334,0.9393939393939394,3.677422975819931,5.585499980413232,6.592052185335521,3.702363385034847,23,23,24,33,9,9,9,9,74,74,73,64,14,14,15,24,3,3,3,3
502,0.6,0.8,0.9473684210526315,0.8666666666666667,1.0,3.6604767119504515,5.12477516571074,6.429987455688771,3.919653765852112,15,19,15,23,5,5,5,5,78,74,78,70,10,14,10,18,7,7,7,7
503,0.6,0.8636363636363636,1.0,0.9117647058823529,0.9310344827586207,3.6794144800327375,5.38124190652628,7.1566383627953805,4.018988790059877,22,13,34,29,5,9,9,5,71,84,63,64,17,4,25,24,7,3,3,7
504,0.6,0.9285714285714286,0.9285714285714286,0.7857142857142857,0.896551724137931,3.8486204260716605,5.663751423128935,6.777539969206288,4.177415384387713,14,14,14,29,5,0,5,5,79,74,79,64,9,14,9,24,7,12,7,7
505,0.6,0.7647058823529411,0.95,0.8571428571428571,0.9166666666666666,3.841053781144441,6.194204501532973,7.332314582430899,4.108425009723827,17,40,14,12,12,5,9,9,83,53,83,85,5,35,5,3,0,7,3,3
506,0.6,0.7857142857142857,0.9166666666666666,0.8888888888888888,0.9285714285714286,3.711977802336612,5.699981941050502,6.572713278026347,3.8284561193184987,14,24,9,14,9,9,9,9,83,73,88,83,5,15,0,5,3,3,3,3
507,0.6,0.8275862068965517,0.8947368421052632,0.7142857142857143,0.9285714285714286,3.671067278997512,4.900032222304582,6.504245013499873,3.6997969329623976,29,19,14,14,5,5,5,5,64,74,79,79,24,14,9,9,7,7,7,7
508,0.6,0.9090909090909091,0.9565217391304348,0.8888888888888888,0.9230769230769231,3.6192219483547605,5.272696627948681,7.292062104423047,3.6844037837456787,22,23,9,26,12,8,9,12,78,73,88,74,10,15,0,14,0,4,3,0
509,0.6,0.7777777777777778,0.7142857142857143,0.7894736842105263,0.9230769230769231,3.77698439364093,5.483202564149754,6.5554374629109295,3.9928379208119114,9,7,19,13,9,0,9,9,88,81,78,84,0,7,10,4,3,12,3,3
510,0.6,0.7857142857142857,0.9333333333333333,1.0,0.967741935483871,3.662644813431627,5.449536460472476,6.306602507469626,4.0512800259404615,14,15,9,31,9,0,9,9,83,73,88,66,5,15,0,22,3,12,3,3
511,0.6,0.8888888888888888,0.9230769230769231,1.0,0.8125,3.5790403517026164,5.318119544397258,6.03699378240059,3.920069256598972,9,13,4,32,9,9,4,12,88,84,88,68,0,4,0,20,3,3,8,0
512,0.6,0.896551724137931,0.9545454545454546,0.8928571428571429,0.9487179487179487,3.7355119584184755,5.820154795822129,7.25317851527397,3.9207443021599104,29,44,28,39,12,12,9,12,71,56,69,61,17,32,19,27,0,0,3,0
513,0.6,0.9,0.75,1.0,0.9111111111111111,3.847067972515738,5.589333057158049,8.227664258559779,4.147636123706151,30,16,40,45,5,0,8,12,63,72,56,55,25,16,32,33,7,12,4,0
514,0.6,0.6923076923076923,0.8888888888888888,0.8518518518518519,0.8333333333333334,3.7528004866539315,5.529559324988739,7.4498898939592015,4.085418901504571,13,36,27,30,5,5,5,5,80,57,66,63,8,31,22,25,7,7,7,7
515,0.6,0.8333333333333334,0.896551724137931,0.9473684210526315,0.8888888888888888,3.701808311619868,5.804785286072342,6.411302767015103,3.8632719814451715,12,29,19,36,5,9,5,5,81,68,74,57,7,20,14,31,7,3,7,7
516,0.6,1.0,1.0,0.7777777777777778,0.85,3.819966641089448,5.409954908178918,7.043072932574969,4.133229842096261,8,12,9,40,5,9,9,9,85,85,88,57,3,3,0,31,7,3,3,3
517,0.6,0.6666666666666666,0.9333333333333333,1.0,0.9230769230769231,3.5813238396620823,5.121463422166963,6.859399221084455,3.9240755779693948,9,15,9,13,0,0,0,0,79,73,79,75,9,15,9,13,12,12,12,12
518,0.6,0.9333333333333333,0.8947368421052632,0.85,0.9444444444444444,3.6737574294917157,5.950492962008784,7.0631267172002,3.863511618945502,15,38,20,18,5,5,5,5,78,55,73,75,10,33,15,13,7,7,7,7
519,0.6,1.0,0.8620689655172413,0.9310344827586207,0.9629629629629629,3.6596108594201198,5.573576211277265,7.297553860226645,3.8843639828164034,17,29,29,27,9,9,12,9,80,68,71,70,8,20,17,18,3,3,0,3
520,0.6,0.8,1.0,0.9,0.8918918918918919,3.503320723347349,5.160114828290348,5.978156579349401,3.5098255855871145,15,16,20,37,5,8,5,8,78,80,73,59,10,8,15,29,7,4,7,4
521,0.6,0.75,0.875,1.0,0.7857142857142857,3.7375395860002336,5.602980911576098,6.529656481431002,3.9786010926961373,8,8,3,28,8,8,3,8,88,88,88,68,0,0,0,20,4,4,9,4
522,0.6,0.868421052631579,0.8695652173913043,0.9444444444444444,0.84,3.737719322471976,5.463041008536842,7.2035911156716494,3.7210046704782735,38,23,54,50,12,12,8,12,62,77,42,50,26,11,46,38,0,0,4,0
523,0.6,0.8333333333333334,0.8421052631578947,1.0,0.967741935483871,3.7863082796780465,5.534946639500551,6.93206242602015,4.083551608356545,12,19,10,31,8,5,5,8,84,74,83,65,4,14,5,23,4,7,7,4
524,0.6,0.9,1.0,0.8,0.9591836734693877,3.7553939306869877,5.239692892067846,6.9603290035118075,4.116028394212028,10,12,30,49,5,9,5,12,83,85,63,51,5,3,25,37,7,3,7,0
525,0.6,0.9565217391304348,0.9545454545454546,0.96,0.9696969696969697,3.734363530232178,5.605671140792514,6.8842803481785655,3.852380925321502,23,22,25,33,9,9,12,9,74,75,75,64,14,13,13,24,3,3,0,3
526,0.6,0.9090909090909091,0.9166666666666666,1.0,0.9333333333333333,3.8190827908292637,5.161919206091117,7.692348741699311,4.13322670677945,11,12,4,30,8,8,0,8,85,84,84,66,3,4,4,22,4,4,12,4
527,0.6,0.84375,0.9302325581395349,0.9130434782608695,0.9230769230769231,3.613085241178155,5.417200782636282,6.917567620762596,3.6925664963830362,32,43,23,52,5,5,5,5,61,50,70,41,27,38,18,47,7,7,7,7
528,0.6,1.0,1.0,1.0,0.8947368421052632,3.5297393544514164,5.884500639230062,6.024741441796343,4.045564235658143,5,29,11,19,5,5,8,5,88,64,85,74,0,24,3,14,7,7,4,7
529,0.6,0.8571428571428571,0.8717948717948718,0.8888888888888888,0.9230769230769231,3.592074034108279,6.021235889569289,6.195538181078139,4.002907453388712,14,39,9,13,5,5,9,5,79,54,88,80,9,34,0,8,7,7,3,7
530,0.6,0.9333333333333333,0.9166666666666666,0.96,0.896551724137931,3.6203166324157148,5.474402248914102,7.276287229794717,3.8316250116425024,15,24,25,29,5,9,5,9,78,73,68,68,10,15,20,20,7,3,7,3
531,0.6,0.6521739130434783,0.875,0.8888888888888888,0.8076923076923077,3.6984828877770686,5.526158221208871,7.018300305089742,3.986514209919176,23,24,18,26,8,9,3,7,73,73,73,69,15,15,15,19,4,3,9,5
532,0.6,0.8108108108108109,0.9130434782608695,0.967741935483871,0.8169014084507042,3.834107374900678,5.4768983459453455,7.237692202413995,3.9045805379147667,37,46,31,71,9,9,5,9,60,51,62,26,28,37,26,62,3,3,7,3
533,0.6,0.75,1.0,0.9166666666666666,0.96,3.5429198525452925,5.417374387566939,6.1314746299591825,3.7666713884220973,8,18,12,25,8,8,12,8,88,78,88,71,0,10,0,17,4,4,0,4
534,0.6,0.75,0.8571428571428571,0.875,0.7916666666666666,3.6119366124998216,5.510339796370095,6.9955963595152495,3.7757524586099414,28,21,24,24,9,5,9,9,69,72,73,73,19,16,15,15,3,7,3,3
535,0.6,0.8421052631578947,0.8928571428571429,0.7368421052631579,0.8636363636363636,3.748603108311929,5.621770358017647,6.595581819944697,3.9320261280507354,19,28,19,22,9,9,9,12,78,69,78,78,10,19,10,10,3,3,3,0
536,0.6,0.875,0.9375,1.0,0.8928571428571429,3.737285689695346,5.903454707540189,6.647518190568393,3.8420075104472953,8,48,8,28,8,8,8,8,88,48,88,68,0,40,0,20,4,4,4,4
537,0.6,0.8260869565217391,0.8958333333333334,0.8947368421052632,0.9696969696969697,3.752228844798454,5.98351642216365,6.886579852841827,4.044462360086832,23,48,19,33,9,12,9,9,74,52,78,64,14,36,10,24,3,0,3,3
538,0.6,0.6428571428571429,0.7647058823529411,0.8387096774193549,0.8571428571428571,3.6203476433681776,5.052345808122952,7.037639950937329,3.8125580719293164,14,17,31,28,9,9,9,9,83,80,66,69,5,8,22,19,3,3,3,3
539,0.6,1.0,0.9230769230769231,0.7857142857142857,0.9411764705882353,3.9593220579932247,6.204478605442406,6.581750069961104,4.242932452815339,9,39,14,34,9,9,9,9,88,58,83,63,0,30,5,25,3,3,3,3
540,0.6,0.9166666666666666,0.8333333333333334,0.9166666666666666,0.8888888888888888,3.6899744483367782,5.33103158508468,6.258332350149343,4.010059748005632,12,18,12,27,5,5,5,9,81,75,81,70,7,13,7,18,7,7,7,3
541,0.6,0.8888888888888888,0.9166666666666666,0.9333333333333333,0.90625,3.709401096925439,5.607334142370195,6.546461382505143,3.8950955993877483,9,36,15,32,9,9,5,9,88,61,78,65,0,27,10,23,3,3,7,3
542,0.6,0.8947368421052632,0.8333333333333334,0.8928571428571429,1.0,3.7768225466704344,5.559908802166123,6.458300322210865,4.065011958916035,19,30,28,13,4,12,4,4,73,70,64,79,15,18,24,9,8,0,8,8
543,0.6,0.6666666666666666,0.9142857142857143,0.9,0.9534883720930233,3.7368703016407725,5.8159719287025515,7.100569548971696,4.048836669103411,18,35,20,43,9,5,5,9,79,58,73,54,9,30,15,34,3,7,7,3
544,0.6,0.75,0.8333333333333334,0.8148148148148148,0.8431372549019608,3.765602757688748,5.801620812431525,7.013536711558789,3.97403082360855,24,36,27,51,9,9,9,9,73,61,70,46,15,27,18,42,3,3,3,3
545,0.6,0.8421052631578947,0.8666666666666667,0.8571428571428571,0.9148936170212766,3.999146401217847,5.905309003773518,7.069481081201479,4.191814133466605,19,30,14,47,5,5,0,8,74,63,74,49,14,25,14,39,7,7,12,4
546,0.6,0.8421052631578947,0.8947368421052632,0.9473684210526315,0.8709677419354839,3.79436696265002,5.53916122922076,7.2148156041548575,4.110447006605973,19,19,19,31,9,5,9,12,78,74,78,69,10,14,10,19,3,7,3,0
547,0.6,0.8888888888888888,1.0,0.6666666666666666,0.9047619047619048,3.7149057385301756,5.518540274750612,6.3725174489709975,3.965663796675306,9,24,9,63,9,9,9,9,88,73,88,34,0,15,0,54,3,3,3,3
548,0.6,1.0,1.0,0.8,1.0,3.647992066747778,5.064872921518203,6.2141289957422385,3.9204058602072718,5,10,5,18,5,5,5,5,88,83,88,75,0,5,0,13,7,7,7,7
549,0.6,0.8947368421052632,0.9285714285714286,0.8,0.85,3.788016387507915,5.40852697506457,6.103930412738647,4.001900027874641,19,28,5,20,9,9,5,5,78,69,88,73,10,19,0,15,3,3,7,7
550,0.6,0.9166666666666666,0.7857142857142857,0.9655172413793104,0.8928571428571429,3.7784023122989967,5.349075813556108,8.113634897358251,4.000844517211257,24,14,29,28,9,9,9,5,73,83,68,65,15,5,20,23,3,3,3,7
551,0.6,0.7777777777777778,0.8235294117647058,0.8333333333333334,0.9,3.8266769307040676,5.411679311210922,7.215730246917135,4.157171282401619,18,17,24,50,5,9,12,12,75,80,76,50,13,8,12,38,7,3,0,0
552,0.6,0.7931034482758621,0.8703703703703703,0.9318181818181818,0.9038461538461539,3.752477071321009,5.959637518612127,7.2084402137933585,3.842828087664295,29,54,44,52,9,8,9,9,68,42,53,45,20,46,35,43,3,4,3,3
553,0.6,0.7,0.9166666666666666,0.9285714285714286,1.0,3.6359248664412562,5.250505558997877,6.7258603034586075,3.9629884499357293,10,24,14,14,5,9,9,5,83,73,83,79,5,15,5,9,7,3,3,7
554,0.6,0.8461538461538461,0.875,0.9,0.8,3.638683202162103,5.390504723858965,7.210620297791661,3.8809067758795406,13,16,10,20,9,9,5,5,84,81,83,73,4,7,5,15,3,3,7,7
555,0.6,0.7333333333333333,0.7894736842105263,0.8,0.918918918918919,3.6242972266874647,5.297691084806675,7.010953717398093,3.951838316606528,15,19,10,37,5,5,0,12,78,74,78,63,10,14,10,25,7,7,12,0
556,0.6,1.0,0.9285714285714286,0.7777777777777778,0.9666666666666667,3.895526727659767,6.04060209112949,6.956548668069994,4.366470184621014,9,28,9,30,9,8,5,9,88,68,84,67,0,20,4,21,3,4,7,3
557,0.6,0.7777777777777778,0.9523809523809523,0.8846153846153846,0.8157894736842105,3.571119344357557,4.984183129899882,6.596800056062015,3.9018083831981216,27,21,26,38,12,12,8,12,73,79,70,62,15,9,18,26,0,0,4,0
558,0.6,0.875,0.8974358974358975,0.8571428571428571,0.9411764705882353,3.4676256897943483,5.579739060936415,6.123503014923658,3.4840313669355987,24,39,28,34,9,9,9,9,73,58,69,63,15,30,19,25,3,3,3,3
559,0.6,0.8235294117647058,0.8333333333333334,0.8823529411764706,1.0,3.5852335330313156,5.742591921584805,6.817018036381173,3.889954957315689,17,48,17,34,8,8,8,5,79,48,79,59,9,40,9,29,4,4,4,7
560,0.6,0.8571428571428571,0.8529411764705882,1.0,0.9411764705882353,3.47142798248677,5.235062476536907,6.987037124138085,3.6430137700414287,14,34,9,34,9,9,9,5,83,63,88,59,5,25,0,29,3,3,3,7
561,0.6,0.9090909090909091,0.8947368421052632,1.0,0.9285714285714286,3.6896214024132443,5.257254189968162,6.8602631522517905,4.116257768241955,11,19,11,14,5,12,5,8,82,81,82,82,6,7,6,6,7,0,7,4
562,0.6,0.9166666666666666,0.9090909090909091,1.0,0.8823529411764706,3.8083382913374866,6.069852175532373,7.348483911240059,3.972480400517814,12,22,5,17,9,9,5,9,85,75,88,80,3,13,0,8,3,3,7,3
563,0.6,0.8846153846153846,0.9696969696969697,0.9047619047619048,0.8478260869565217,3.6709041876980866,5.448254517758535,6.301068951468554,3.8883053953853595,26,33,21,46,5,5,5,5,67,60,72,47,21,28,16,41,7,7,7,7
564,0.6,0.8888888888888888,0.75,0.9444444444444444,0.9285714285714286,3.7862082032182136,5.264444544602194,7.83105091835645,4.033170814588243,9,8,18,14,9,5,12,9,88,85,82,83,0,3,6,5,3,7,0,3
565,0.6,0.875,0.8,0.7391304347826086,0.9310344827586207,3.76251200802941,5.3343986154122645,6.665371230715626,4.088732492065711,8,5,23,29,8,5,5,5,88,88,70,64,0,0,18,24,4,7,7,7
566,0.6,0.7142857142857143,1.0,1.0,1.0,3.696099979437551,5.411780723751292,7.326173442593995,3.9919299777603947,14,14,22,18,9,9,12,4,83,83,78,74,5,5,10,14,3,3,0,8
567,0.6,0.8571428571428571,0.9333333333333333,1.0,0.9655172413793104,3.9562501800709473,5.911572072422478,7.077278307064441,4.2573859600053945,21,15,10,29,5,5,5,5,72,78,83,64,16,10,5,24,7,7,7,7
568,0.6,0.8461538461538461,0.9629629629629629,1.0,0.967741935483871,3.6611421896060317,5.44205025418312,6.415935048326177,3.9434664719511128,13,27,15,31,9,5,5,9,84,66,78,66,4,22,10,22,3,7,7,3
569,0.6,0.8,0.5,0.8,0.9166666666666666,3.890885860998342,5.759412701773692,6.821404344167729,4.529040009856375,5,4,5,12,5,0,5,8,88,84,88,84,0,4,0,4,7,12,7,4
570,0.6,0.8235294117647058,0.7777777777777778,1.0,0.9655172413793104,3.773511609998452,5.379104619954551,6.746433036643678,4.035886015103005,17,9,5,29,9,4,5,9,80,83,88,68,8,5,0,20,3,8,7,3
571,0.6,0.8181818181818182,1.0,0.8461538461538461,0.8888888888888888,3.879528098206477,5.552427842951219,7.244654264940992,4.0087805504288845,22,21,13,27,9,9,9,9,75,76,84,70,13,12,4,18,3,3,3,3
572,0.6,0.9,0.9565217391304348,1.0,0.96,3.67929810445589,5.782985605677294,6.812487816584678,4.181876503795131,10,23,5,25,5,4,5,5,83,69,88,68,5,19,0,20,7,8,7,7
573,0.6,0.9,0.9047619047619048,1.0,0.9642857142857143,3.7476562153834316,5.212262349359635,6.947874370528763,3.945684855386829,10,21,5,28,5,8,5,5,83,75,88,65,5,13,0,23,7,4,7,7
574,0.6,0.7777777777777778,0.9230769230769231,0.7777777777777778,0.9444444444444444,3.4838170768726693,4.949408856161702,5.8562748808892024,3.766944675013619,9,13,9,36,9,9,9,12,88,84,88,64,0,4,0,24,3,3,3,0
575,0.6,1.0,0.918918918918919,0.7272727272727273,0.9130434782608695,3.7347105299864123,6.144968157029578,6.481174291544876,4.296972407791912,4,37,11,23,0,9,3,5,84,60,80,70,4,28,8,18,12,3,9,7
576,0.6,1.0,0.95,0.9411764705882353,0.9583333333333334,3.52765016194631,5.3454601746796415,6.838667519092998,3.8496929108854014,9,20,17,48,9,5,7,9,88,73,78,49,0,15,10,39,3,7,5,3
577,0.6,0.7619047619047619,0.9032258064516129,1.0,0.918918918918919,3.585733193811407,5.566077545440271,7.300072646297788,3.87037677413317,21,31,19,37,9,9,9,8,76,66,78,59,12,22,10,29,3,3,3,4
578,0.6,0.9411764705882353,0.9333333333333333,0.9411764705882353,0.9333333333333333,3.4562411562265036,5.174351376095045,5.619396753694959,3.6834943281786394,17,15,17,30,9,5,9,9,80,78,80,67,8,10,8,21,3,7,3,3
579,0.6,0.5882352941176471,0.9705882352941176,0.7083333333333334,0.9047619047619048,3.921424696493645,6.232969628587501,7.444341282712294,4.127206527786534,17,34,24,21,9,9,12,8,80,63,76,75,8,25,12,13,3,3,0,4
580,0.6,0.8666666666666667,0.85,0.9473684210526315,0.918918918918919,3.5593047127665405,5.150792793166711,6.9887302144241445,3.8812935794427674,15,20,19,37,9,5,5,9,82,73,74,60,6,15,14,28,3,7,7,3
581,0.6,0.75,0.9259259259259259,1.0,0.8947368421052632,3.797481395917378,6.316382463405814,7.00642804639071,3.9800221347066977,12,54,12,19,9,9,12,9,85,43,88,78,3,45,0,10,3,3,0,3
582,0.6,0.8421052631578947,0.9473684210526315,0.8695652173913043,1.0,3.4965640991496962,4.942620990922215,6.383009718140969,3.8769692041812647,19,19,23,22,9,5,9,12,78,74,74,78,10,14,14,10,3,7,3,0
583,0.6,0.8636363636363636,0.8636363636363636,0.8333333333333334,0.7555555555555555,3.758155698402511,5.61507278997902,6.581272515121109,3.944213033452718,22,22,18,45,12,4,8,12,78,70,78,55,10,18,10,33,0,8,4,0
584,0.6,0.6923076923076923,0.8888888888888888,0.8888888888888888,0.8461538461538461,3.644372679811007,5.308865200818325,6.6947825224800095,4.076528067819573,13,18,9,13,9,9,4,9,84,79,83,84,4,9,5,4,3,3,8,3
585,0.6,0.8823529411764706,0.9130434782608695,0.9629629629629629,0.8928571428571429,3.7504778219398656,5.972479072622994,7.809657527244479,3.8166695928522025,17,23,27,28,9,9,9,9,80,74,70,69,8,14,18,19,3,3,3,3
586,0.6,0.7692307692307693,1.0,0.7692307692307693,0.875,3.625361822444913,4.869825786859932,6.219908717992382,3.8838841676280205,13,5,13,24,5,5,5,5,80,88,80,69,8,0,8,19,7,7,7,7
587,0.6,0.9333333333333333,0.7777777777777778,0.9333333333333333,0.8888888888888888,3.6890351550119074,5.3036021128978215,7.1508542482807576,3.8523788034987394,15,36,30,45,5,12,12,12,78,64,70,55,10,24,18,33,7,0,0,0
588,0.6,0.8888888888888888,0.8636363636363636,1.0,0.8888888888888888,3.611712964763841,5.142728208232471,7.098546274842921,3.8162388678215007,9,22,9,18,9,9,9,8,88,75,88,78,0,13,0,10,3,3,3,4
589,0.6,0.8421052631578947,0.9666666666666667,0.8695652173913043,0.9166666666666666,3.75106594243446,5.775553570717482,6.832880086061403,3.917178894054395,19,30,23,36,9,12,9,9,78,70,74,61,10,18,14,27,3,0,3,3
590,0.6,0.84375,0.9459459459459459,0.7777777777777778,0.84375,3.8301820641927877,6.110289190300435,6.49574455509767,4.109573943064163,32,37,9,32,9,9,9,9,65,60,88,65,23,28,0,23,3,3,3,3
591,0.6,0.7142857142857143,0.9230769230769231,0.875,0.8947368421052632,3.594521075968462,5.639201153951428,6.875125354997451,3.7902098607225883,28,26,32,38,9,9,8,5,69,71,64,55,19,17,24,33,3,3,4,7
592,0.6,0.7692307692307693,0.9347826086956522,0.7777777777777778,0.8958333333333334,3.4737603209531747,5.4259792564595895,6.338491733183527,3.6385372548287975,13,46,18,48,8,8,8,8,83,50,78,48,5,38,10,40,4,4,4,4
593,0.6,0.8,0.9090909090909091,1.0,1.0,3.608912844906345,5.2161571725241735,6.470161452406633,4.156763833669271,5,11,10,9,5,8,5,5,88,85,83,84,0,3,5,4,7,4,7,7
594,0.6,0.625,0.8571428571428571,1.0,0.9411764705882353,3.8369551280651364,5.350312411892432,7.5126081598900685,4.2036281179111015,16,14,18,17,9,5,5,9,81,79,75,80,7,9,13,8,3,7,7,3
595,0.6,0.6666666666666666,0.8620689655172413,0.8787878787878788,0.7954545454545454,3.5881565496162278,5.486416847419994,6.545722184081834,3.7046266249086983,36,29,33,44,9,9,12,9,61,68,67,53,27,20,21,35,3,3,0,3
596,0.6,0.8461538461538461,0.8928571428571429,0.90625,0.9038461538461539,3.637350683044413,5.456482644060652,6.944311598218526,3.75519472333847,26,28,32,52,12,9,12,12,74,69,68,48,14,19,20,40,0,3,0,0
597,0.6,0.8888888888888888,0.8648648648648649,0.9583333333333334,0.8809523809523809,3.4616966099560953,5.512818419239822,6.585915447752154,3.7480028768109706,9,37,24,42,9,4,9,9,88,55,73,55,0,33,15,33,3,8,3,3
598,0.6,0.7666666666666667,0.7419354838709677,0.7647058823529411,0.8387096774193549,3.808353102290481,5.478640442677393,6.71014012649196,3.8133367629145556,30,31,34,31,7,5,7,4,65,62,61,61,23,26,27,27,5,7,5,8
599,0.6,0.6923076923076923,0.9130434782608695,1.0,0.8837209302325582,3.7277495707634802,5.229625767561143,7.259015983124187,4.1285555889797125,13,23,24,43,9,9,9,12,84,74,73,57,4,14,15,31,3,3,3,0
600,0.7,0.75,0.8518518518518519,0.5833333333333334,0.94,3.6827363786094356,5.603168040453135,7.126423197815057,4.130353058562681,16,27,12,50,9,9,5,9,81,70,81,47,7,18,7,41,3,3,7,3
601,0.7,0.7391304347826086,0.9130434782608695,0.8333333333333334,0.8333333333333334,3.6777843613824754,5.585328818930142,6.590733820313361,3.9252573349782307,23,23,24,36,9,9,9,12,74,74,73,64,14,14,15,24,3,3,3,0
602,0.7,0.8,0.9473684210526315,0.8666666666666667,1.0,3.6628997091486792,5.130854792870893,6.432259251951686,3.9189098815352033,15,19,15,23,5,5,5,5,78,74,78,70,10,14,10,18,7,7,7,7
603,0.7,0.8636363636363636,1.0,0.9117647058823529,0.9696969696969697,3.683416389633544,5.3829531019810455,7.156838705101699,4.010289340400594,22,13,34,33,5,9,9,9,71,84,63,64,17,4,25,24,7,3,3,3
604,0.7,0.9285714285714286,0.9285714285714286,0.7857142857142857,0.8484848484848485,3.8513192308711433,5.682952648865092,6.784041047428615,4.399663765572966,14,14,14,33,5,0,5,9,79,74,79,64,9,14,9,24,7,12,7,3
605,0.7,0.7647058823529411,0.95,0.8571428571428571,0.9166666666666666,3.841053781144441,6.20828530099283,7.331837059475395,4.1002634316325635,17,40,14,12,12,5,9,9,83,53,83,85,5,35,5,3,0,7,3,3
606,0.7,0.7857142857142857,0.9166666666666666,0.9473684210526315,0.9285714285714286,3.7122987258284645,5.700845732359476,6.965072288380173,3.8161590385186117,14,24,19,14,9,9,9,9,83,73,78,83,5,15,10,5,3,3,3,3
607,0.7,0.8275862068965517,0.8947368421052632,0.7142857142857143,0.9444444444444444,3.6741584770800024,4.905803813316805,6.510326303715028,3.8033581831693133,29,19,14,18,5,5,5,9,64,74,79,79,24,14,9,9,7,7,7,3
608,0.7,0.8518518518518519,0.9565217391304348,0.8888888888888888,0.9230769230769231,3.603063323702529,5.2803575508724805,7.2936544516122,3.7178703337135697,27,23,9,26,12,8,9,12,73,73,88,74,15,15,0,14,0,4,3,0
609,0.7,0.7777777777777778,0.8076923076923077,0.7894736842105263,0.9230769230769231,3.7772418480354566,5.770770387986193,6.5568238885730095,4.163944481290054,9,26,19,13,9,4,9,9,88,66,78,84,0,22,10,4,3,8,3,3
610,0.7,0.7857142857142857,0.95,1.0,0.967741935483871,3.663021120741559,5.3800007590641,6.3354329223172305,4.052307770548627,14,20,12,31,9,5,12,9,83,73,88,66,5,15,0,22,3,7,0,3
611,0.7,0.8888888888888888,0.9230769230769231,1.0,0.8125,3.579395610011993,5.31914390894813,6.056853548812464,3.914935111957863,9,13,4,32,9,9,4,12,88,84,88,68,0,4,0,20,3,3,8,0
612,0.7,0.896551724137931,0.9545454545454546,0.8928571428571429,0.9487179487179487,3.7355119584184755,5.820154795822129,7.25664090285652,3.9134784082386354,29,44,28,39,12,12,9,12,71,56,69,61,17,32,19,27,0,0,3,0
613,0.7,0.9,0.75,1.0,0.9111111111111111,3.850211016746223,5.60582775829283,8.235695598870143,3.9955399155887585,30,16,40,45,5,0,8,12,63,72,56,55,25,16,32,33,7,12,4,0
614,0.7,0.6923076923076923,0.9,0.8518518518518519,0.8333333333333334,3.7547972513719023,5.604635475434064,7.453137090537468,4.0796144065278614,13,40,27,30,5,9,5,5,80,57,66,63,8,31,22,25,7,3,7,7
615,0.7,0.8333333333333334,0.896551724137931,0.9473684210526315,0.8888888888888888,3.7042565098719833,5.804963857355297,6.421290057170241,3.8603988965793965,12,29,19,36,5,9,5,5,81,68,74,57,7,20,14,31,7,3,7,7
616,0.7,0.75,1.0,0.7777777777777778,0.9333333333333333,3.874934156104953,5.410044012770314,7.044459550548613,4.196388516683566,12,12,9,30,9,9,9,9,85,85,88,67,3,3,0,21,3,3,3,3
617,0.7,0.6666666666666666,0.9333333333333333,1.0,0.8461538461538461,3.5862917640345304,5.134853184659736,6.8783892773377096,3.9221626888444914,9,15,9,13,0,0,0,0,79,73,79,75,9,15,9,13,12,12,12,12
618,0.7,0.9333333333333333,0.8947368421052632,0.85,0.9444444444444444,3.6766758374626116,5.955269429870335,7.073804584232879,3.851200824317447,15,38,20,18,5,5,5,5,78,55,73,75,10,33,15,13,7,7,7,7
619,0.7,1.0,0.8620689655172413,0.9310344827586207,1.0,3.6607462764116416,5.575404593440187,7.297553860226644,3.7493778950908796,17,29,29,27,9,9,12,9,80,68,71,70,8,20,17,18,3,3,0,3
620,0.7,0.8,1.0,0.9,0.8648648648648649,3.5050684823784812,5.165037443051537,5.983898960052319,3.6135292251596387,15,16,20,37,5,8,5,8,78,80,73,59,10,8,15,29,7,4,7,4
621,0.7,0.75,0.875,0.5,0.7857142857142857,3.7395793114058717,5.604099186359502,6.485556561417441,3.9754140574947257,8,8,8,28,8,8,8,8,88,88,88,68,0,0,0,20,4,4,4,4
622,0.7,0.868421052631579,0.8695652173913043,0.9137931034482759,0.84,3.737719322471976,5.463041008536842,7.048240465468222,3.718056228238365,38,23,58,50,12,12,12,12,62,77,42,50,26,11,46,38,0,0,0,0
623,0.7,0.8333333333333334,0.8636363636363636,1.0,0.967741935483871,3.788696854830445,5.597820211697684,6.941660014921803,4.080592318220846,12,22,10,31,8,8,5,8,84,74,83,65,4,14,5,23,4,4,7,4
624,0.7,0.9,1.0,0.8,0.9591836734693877,3.7587473353422483,5.240670831120632,6.963525245087082,4.106891267400388,10,12,30,49,5,9,5,12,83,85,63,51,5,3,25,37,7,3,7,0
625,0.7,0.9565217391304348,0.9545454545454546,0.96,0.9696969696969697,3.735229693138337,5.607341860895081,6.884280348178563,3.849777856317361,23,22,25,33,9,9,12,9,74,75,75,64,14,13,13,24,3,3,0,3
626,0.7,0.9090909090909091,0.9166666666666666,1.0,0.9333333333333333,3.8201082411119462,5.165865960310938,7.737183840594735,4.125384321618495,11,12,4,30,8,8,0,8,85,84,84,66,3,4,4,22,4,4,12,4
627,0.7,0.84375,0.9302325581395349,0.9130434782608695,0.8846153846153846,3.614740207872572,5.4198015932908605,6.920631136111901,3.7267216867665387,32,43,23,52,5,5,5,5,61,50,70,41,27,38,18,47,7,7,7,7
628,0.7,1.0,1.0,1.0,0.9565217391304348,3.532527287681655,5.894285331164301,6.024922207110203,3.8340253537721822,5,29,11,23,5,5,8,9,88,64,85,74,0,24,3,14,7,7,4,3
629,0.7,0.8571428571428571,0.8717948717948718,0.8888888888888888,0.8235294117647058,3.5952111641066264,6.0259441096423005,6.197210443552606,3.963173182790309,14,39,9,17,5,5,9,9,79,54,88,80,9,34,0,8,7,7,3,3
630,0.7,0.9333333333333333,0.9166666666666666,0.96,0.896551724137931,3.623523182458348,5.47324771170983,7.286771927438174,3.8168687986755545,15,24,25,29,5,9,5,9,78,73,68,68,10,15,20,20,7,3,7,3
631,0.7,0.6521739130434783,0.875,0.8888888888888888,0.8076923076923077,3.6986688925886004,5.52765758706022,7.035990801183529,3.9840052880572725,23,24,18,26,8,9,3,7,73,73,73,69,15,15,15,19,4,3,9,5
632,0.7,0.8108108108108109,0.9130434782608695,0.967741935483871,0.8591549295774648,3.834140795653542,5.476554646602082,7.243655820458254,3.8957185255088627,37,46,31,71,9,9,5,9,60,51,62,26,28,37,26,62,3,3,7,3
633,0.7,0.75,1.0,0.9166666666666666,0.9545454545454546,3.544406642847873,5.421458879334703,6.1314746299591825,3.8621424318253657,8,18,12,22,8,8,12,5,88,78,88,71,0,10,0,17,4,4,0,7
634,0.7,0.75,0.8571428571428571,0.875,0.875,3.611876436296604,5.517552464348817,6.995709446985245,3.7928757334332346,28,21,24,24,9,5,9,9,69,72,73,73,19,16,15,15,3,7,3,3
635,0.7,0.8421052631578947,0.8928571428571429,0.7368421052631579,0.8636363636363636,3.748874130044868,5.622570310990475,6.597946681422042,3.922989234055703,19,28,19,22,9,9,9,12,78,69,78,78,10,19,10,10,3,3,3,0
636,0.7,0.875,0.9375,1.0,0.9642857142857143,3.7403016893399545,5.906633256464782,6.651669625185927,3.7787503274561525,8,48,8,28,8,8,8,8,88,48,88,68,0,40,0,20,4,4,4,4
637,0.7,0.8260869565217391,0.8958333333333334,0.8947368421052632,0.9696969696969697,3.7526867963486144,5.983516422163649,6.888104528985644,4.042572990702522,23,48,19,33,9,12,9,9,74,52,78,64,14,36,10,24,3,0,3,3
638,0.7,0.6428571428571429,0.7647058823529411,0.8387096774193549,0.8571428571428571,3.6204640155677414,5.052875414582196,7.035949331376314,3.8098486165222094,14,17,31,28,9,9,9,9,83,80,66,69,5,8,22,19,3,3,3,3
639,0.7,1.0,0.9230769230769231,0.7857142857142857,0.9411764705882353,3.959724594652078,6.2049902184044745,6.582154674410837,4.229565710441133,9,39,14,34,9,9,9,9,88,58,83,63,0,30,5,25,3,3,3,3
640,0.7,0.9166666666666666,0.8888888888888888,0.9166666666666666,0.9629629629629629,3.692531373744988,5.3370763999719,6.263040457774672,4.081215715491966,12,18,12,27,5,5,5,9,81,75,81,70,7,13,7,18,7,7,7,3
641,0.7,0.8888888888888888,0.9166666666666666,0.9333333333333333,0.90625,3.7103635597686204,5.609991559325788,6.564717805290476,3.8940333885887854,9,36,15,32,9,9,5,9,88,61,78,65,0,27,10,23,3,3,7,3
642,0.7,0.8947368421052632,0.8333333333333334,0.8928571428571429,1.0,3.783739158874846,5.559908802166123,6.47513188084899,3.950483658008599,19,30,28,13,4,12,4,4,73,70,64,79,15,18,24,9,8,0,8,8
643,0.7,0.6428571428571429,0.9142857142857143,0.9,0.9302325581395349,3.7435195699916726,5.816862565382001,7.097110553035934,3.9640563192145355,14,35,20,43,9,5,5,9,83,58,73,54,5,30,15,34,3,7,7,3
644,0.7,0.75,0.8333333333333334,0.8148148148148148,0.8823529411764706,3.76606245724883,5.803235035918487,7.016110656462904,4.044253145196838,24,36,27,51,9,9,9,9,73,61,70,46,15,27,18,42,3,3,3,3
645,0.7,0.8695652173913043,0.8666666666666667,0.8571428571428571,0.8823529411764706,4.007986632156451,5.912299989606959,7.09400197591997,4.108354462850773,23,30,14,51,9,5,0,12,74,63,74,49,14,25,14,39,3,7,12,0
646,0.7,0.8421052631578947,0.8947368421052632,0.9473684210526315,0.8928571428571429,3.7943209412990417,5.54436518152422,7.213504689589027,4.066777480023671,19,19,19,28,9,5,9,9,78,74,78,69,10,14,10,19,3,7,3,3
647,0.7,0.8888888888888888,1.0,0.6666666666666666,0.9047619047619048,3.71540628482293,5.519738027342221,6.374719773920733,3.9602011161824966,9,24,9,63,9,9,9,9,88,73,88,34,0,15,0,54,3,3,3,3
648,0.7,1.0,1.0,0.8,1.0,3.6487667649105986,5.066128221124555,6.217256543487018,4.02675705709175,5,10,5,18,5,5,5,5,88,83,88,75,0,5,0,13,7,7,7,7
649,0.7,0.8947368421052632,0.9285714285714286,0.8,0.8333333333333334,3.7878555781528336,5.408848581349168,6.106254392404854,4.045665712616834,19,28,5,24,9,9,5,9,78,69,88,73,10,19,0,15,3,3,7,3
650,0.7,0.9166666666666666,0.7857142857142857,0.9655172413793104,0.8064516129032258,3.77888166621678,5.349531835035338,8.113663654042188,3.94097716026231,24,14,29,31,9,9,9,8,73,83,68,65,15,5,20,23,3,3,3,4
651,0.7,0.8181818181818182,0.8235294117647058,0.8333333333333334,0.9,3.813597221391115,5.413498974863741,7.215730246917135,4.152151959003629,22,17,24,50,9,9,12,12,75,80,76,50,13,8,12,38,3,3,0,0
652,0.7,0.7931034482758621,0.8703703703703703,0.9318181818181818,0.9038461538461539,3.752604926417282,5.9649544744344425,7.20907987710957,3.842150163873463,29,54,44,52,9,8,9,9,68,42,53,45,20,46,35,43,3,4,3,3
653,0.7,0.7142857142857143,0.9166666666666666,0.9285714285714286,1.0,3.622415466405432,5.251329346485202,6.726239646362147,3.9559550791022966,14,24,14,14,9,9,9,5,83,73,83,79,5,15,5,9,3,3,3,7
654,0.7,0.8461538461538461,0.875,0.9,0.8518518518518519,3.6392740854431262,5.391401600301222,7.216296674606238,3.946194548570647,13,16,10,27,9,9,5,12,84,81,83,73,4,7,5,15,3,3,7,0
655,0.7,0.7333333333333333,0.7894736842105263,0.8,0.8918918918918919,3.6235022231214837,5.294774473744442,7.042778791619258,3.884114262459594,15,19,10,37,5,5,0,12,78,74,78,63,10,14,10,25,7,7,12,0
656,0.7,1.0,0.9285714285714286,0.7777777777777778,0.9666666666666667,3.8959851507181518,6.047368078979957,6.961904391210112,4.365014767122156,9,28,9,30,9,8,5,9,88,68,84,67,0,20,4,21,3,4,7,3
657,0.7,0.7777777777777778,0.9375,0.8846153846153846,0.8157894736842105,3.571119344357557,4.912441161346942,6.600698023282849,3.8928111799177723,27,16,26,38,12,12,8,12,73,84,70,62,15,4,18,26,0,0,4,0
658,0.7,0.875,0.8974358974358975,0.8571428571428571,0.9411764705882353,3.4673252729270367,5.579239624104734,6.122433167418883,3.482478949543526,24,39,28,34,9,9,9,9,73,58,69,63,15,30,19,25,3,3,3,3
659,0.7,0.8235294117647058,0.8333333333333334,0.8823529411764706,1.0,3.586884501727504,5.743912111184666,6.824386712742144,3.8826336272284303,17,48,17,34,8,8,8,5,79,48,79,59,9,40,9,29,4,4,4,7
660,0.7,0.8571428571428571,0.8529411764705882,1.0,0.9117647058823529,3.4710759929386197,5.234511698696388,6.985317198212719,3.6022714516102505,14,34,9,34,9,9,9,5,83,63,88,59,5,25,0,29,3,3,3,7
661,0.7,0.6666666666666666,0.8947368421052632,1.0,0.9285714285714286,3.6871267310040854,5.257254189968162,6.861872139670666,4.1083661056527,15,19,11,14,5,12,5,8,78,81,82,82,10,7,6,6,7,0,7,4
662,0.7,0.9166666666666666,0.9090909090909091,1.0,0.8823529411764706,3.8080468947184234,6.0689243628228775,7.360502290655698,4.1445193925544315,12,22,5,17,9,9,5,9,85,75,88,80,3,13,0,8,3,3,7,3
663,0.7,0.8846153846153846,0.972972972972973,0.9047619047619048,0.9130434782608695,3.6711938985895,5.525899079325816,6.308538633810757,3.8923560227647838,26,37,21,46,5,9,5,5,67,60,72,47,21,28,16,41,7,3,7,7
664,0.7,0.9285714285714286,0.75,0.9444444444444444,0.8571428571428571,3.8324577800702464,5.266777230053129,7.83105091835645,3.9029456648149883,14,8,18,14,9,5,12,9,83,85,82,83,5,3,6,5,3,7,0,3
665,0.7,0.875,0.8,0.7391304347826086,0.9310344827586207,3.764317064647933,5.3382914734625375,6.668133199956218,4.088084745754547,8,5,23,29,8,5,5,5,88,88,70,64,0,0,18,24,4,7,7,7
666,0.7,0.7142857142857143,1.0,1.0,1.0,3.696779018196413,5.412643419511906,7.326173442593997,3.985423915187548,14,14,22,18,9,9,12,4,83,83,78,74,5,5,10,14,3,3,0,8
667,0.7,0.8571428571428571,0.8947368421052632,1.0,0.9655172413793104,3.958422655818236,5.9944779063160105,7.079471635006188,4.254309291763028,21,19,10,29,5,9,5,5,72,78,83,64,16,10,5,24,7,3,7,7
668,0.7,0.8461538461538461,0.9629629629629629,1.0,0.9354838709677419,3.661546974663154,5.4499022397088215,6.422996994283392,3.9826557077370865,13,27,15,31,9,5,5,9,84,66,78,66,4,22,10,22,3,7,7,3
669,0.7,0.8,0.5,0.8,0.9166666666666666,3.891993816863476,5.772547813806819,6.824356328865996,4.499725073368928,5,4,5,12,5,0,5,8,88,84,88,84,0,4,0,4,7,12,7,4
670,0.7,0.8235294117647058,0.7777777777777778,1.0,0.9310344827586207,3.7730569288331366,5.3950579121143,6.793029014907334,4.0140968607838206,17,9,9,29,9,4,9,9,80,83,88,68,8,5,0,20,3,8,3,3
671,0.7,0.8181818181818182,1.0,0.8461538461538461,0.8888888888888888,3.8793797887617187,5.551740380264882,7.243707046139338,4.176351344219656,22,21,13,27,9,9,9,9,75,76,84,70,13,12,4,18,3,3,3,3
672,0.7,0.9,0.9285714285714286,1.0,0.96,3.6801105175442586,5.853752635536394,6.812872814715201,4.176018222959591,10,28,5,25,5,9,5,5,83,69,88,68,5,19,0,20,7,3,7,7
673,0.7,0.9,0.9047619047619048,1.0,1.0,3.748842694003259,5.211323848181458,6.9498539160764965,3.930229113165602,10,21,5,28,5,8,5,5,83,75,88,65,5,13,0,23,7,4,7,7
674,0.7,0.7777777777777778,0.9230769230769231,0.7777777777777778,0.9444444444444444,3.48411955153894,4.949611476173463,5.857159631232114,3.7585411083680835,9,13,9,36,9,9,9,12,88,84,88,64,0,4,0,24,3,3,3,0
675,0.7,0.8461538461538461,0.918918918918919,0.7272727272727273,0.8888888888888888,3.8181532772466986,6.145562102830074,6.507371010307159,4.22160586730465,13,37,11,27,9,9,3,9,84,60,80,70,4,28,8,18,3,3,9,3
676,0.7,1.0,0.95,0.9411764705882353,0.9375,3.527728471828208,5.354224942384777,6.857729235990324,3.9338752052855788,9,20,17,48,9,5,7,9,88,73,78,49,0,15,10,39,3,7,5,3
677,0.7,0.7619047619047619,0.9032258064516129,1.0,0.8918918918918919,3.58590412583519,5.566543158075592,7.301387959155143,3.936419945998027,21,31,19,37,9,9,9,8,76,66,78,59,12,22,10,29,3,3,3,4
678,0.7,0.9411764705882353,0.9333333333333333,0.9411764705882353,0.9333333333333333,3.4565268597895917,5.179898757006415,5.621205933613258,3.678890702333482,17,15,17,30,9,5,9,9,80,78,80,67,8,10,8,21,3,7,3,3
679,0.7,0.5882352941176471,0.9705882352941176,0.7083333333333334,0.8571428571428571,3.922039489661328,6.2340302266688905,7.444341282712294,4.121544199008479,17,34,24,21,9,9,12,8,80,63,76,75,8,25,12,13,3,3,0,4
680,0.7,0.8666666666666667,0.85,0.9473684210526315,0.972972972972973,3.5597640839624556,5.159493961725571,7.002532802182213,3.844247988148272,15,20,19,37,9,5,5,9,82,73,74,60,6,15,14,28,3,7,7,3
681,0.7,0.75,0.9259259259259259,1.0,0.9473684210526315,3.7973647206039693,6.315374069416188,7.00642804639071,4.1204871495892625,12,54,12,19,9,9,12,9,85,43,88,78,3,45,0,10,3,3,0,3
682,0.7,0.8421052631578947,0.9473684210526315,0.8695652173913043,1.0,3.496151120051948,4.947228756228685,6.383559840044613,3.8746668842895087,19,19,23,22,9,5,9,12,78,74,74,78,10,14,14,10,3,7,3,0
683,0.7,0.7894736842105263,0.8333333333333334,0.8333333333333334,0.7777777777777778,3.7698727029177177,5.5308380527953265,6.58362814007433,3.937218772600409,19,18,18,45,9,4,8,12,78,74,78,55,10,14,10,33,3,8,4,0
684,0.7,0.6923076923076923,0.8888888888888888,0.8888888888888888,0.7692307692307693,3.6442517235828524,5.308901875676436,6.721959910952744,3.9709106122654556,13,18,9,13,9,9,4,9,84,79,83,84,4,9,5,4,3,3,8,3
685,0.7,0.8823529411764706,0.9130434782608695,0.9629629629629629,0.8928571428571429,3.750907431515936,5.973216474813537,7.811537239923702,3.7967955708935017,17,23,27,28,9,9,9,9,80,74,70,69,8,14,18,19,3,3,3,3
686,0.7,0.7692307692307693,1.0,0.7692307692307693,0.8333333333333334,3.6265198012438655,4.869273268093417,6.220183677290653,3.8971699176256496,13,5,13,24,5,5,5,5,80,88,80,69,8,0,8,19,7,7,7,7
687,0.7,0.9333333333333333,0.7777777777777778,0.9333333333333333,0.8444444444444444,3.690001672038448,5.3036021128978215,7.1508542482807576,3.87788415033247,15,36,30,45,5,12,12,12,78,64,70,55,10,24,18,33,7,0,0,0
688,0.7,0.8888888888888888,0.8636363636363636,1.0,0.8888888888888888,3.612013605891426,5.142872389345776,7.098639945619908,3.710268849417986,9,22,9,18,9,9,9,8,88,75,88,78,0,13,0,10,3,3,3,4
689,0.7,0.8421052631578947,0.9666666666666667,0.8695652173913043,0.9722222222222222,3.7520623307880725,5.775553570717481,6.83454073992265,3.9311645105179576,19,30,23,36,9,12,9,9,78,70,74,61,10,18,14,27,3,0,3,3
690,0.7,0.84375,0.9259259259259259,0.7777777777777778,0.84375,3.8302466895615943,5.92271731057403,6.496481141615232,4.103924278567241,32,27,9,32,9,9,9,9,65,70,88,65,23,18,0,23,3,3,3,3
691,0.7,0.7142857142857143,0.8695652173913043,0.875,0.868421052631579,3.595168233905462,5.582993716412239,6.889479417934243,3.719774244518289,28,23,32,38,9,9,8,5,69,74,64,55,19,14,24,33,3,3,4,7
692,0.7,0.7692307692307693,0.9347826086956522,0.7777777777777778,0.8958333333333334,3.4746786266053102,5.431216873734301,6.347887346837269,3.63855722880108,13,46,18,48,8,8,8,8,83,50,78,48,5,38,10,40,4,4,4,4
693,0.7,0.8,1.0,1.0,1.0,3.610695534449499,5.214407452482932,6.475240163209608,4.153784723473273,5,8,10,9,5,5,5,5,88,85,83,84,0,3,5,4,7,7,7,7
694,0.7,0.625,0.8571428571428571,1.0,1.0,3.836756090854153,5.358889846928465,7.516855432880931,4.152536212643681,16,14,18,17,9,5,5,9,81,79,75,80,7,9,13,8,3,7,7,3
695,0.7,0.6666666666666666,0.8205128205128205,0.8787878787878788,0.8409090909090909,3.588699744903477,5.540386283849589,6.545722184081833,3.6583865722592317,36,39,33,44,9,9,12,9,61,58,67,53,27,30,21,35,3,3,0,3
696,0.7,0.8461538461538461,0.8928571428571429,0.90625,0.8846153846153846,3.637350683044413,5.458855036656426,6.944311598218526,3.7434880734688707,26,28,32,52,12,9,12,12,74,69,68,48,14,19,20,40,0,3,0,0
697,0.7,0.8888888888888888,0.8648648648648649,0.9583333333333334,0.9285714285714286,3.4614297420344857,5.530257047846224,6.582988727082314,3.6571798265432833,9,37,24,42,9,4,9,9,88,55,73,55,0,33,15,33,3,8,3,3
698,0.7,0.7666666666666667,0.7428571428571429,0.7941176470588235,0.8709677419354839,3.812923806700464,5.458492978571975,6.717385041175485,3.9357833222004563,30,35,34,31,7,9,7,4,65,62,61,61,23,26,27,27,5,3,5,8
699,0.7,0.6923076923076923,0.9130434782608695,1.0,0.8837209302325582,3.727933698892198,5.229160827700906,7.261472012656654,4.126432536715644,13,23,24,43,9,9,9,12,84,74,73,57,4,14,15,31,3,3,3,0
700,0.7999999999999999,0.75,0.8518518518518519,0.5833333333333334,0.96,3.682879342386507,5.6044666313331595,7.1409781167187,4.129677503267783,16,27,12,50,9,9,5,9,81,70,81,47,7,18,7,41,3,3,7,3
701,0.7999999999999999,0.7391304347826086,0.9130434782608695,0.8333333333333334,0.8333333333333334,3.6781494656446574,5.585206733165861,6.589570277971343,3.9205146037374963,23,23,24,36,9,9,9,12,74,74,73,64,14,14,15,24,3,3,3,0
702,0.7999999999999999,0.8,0.9473684210526315,0.8947368421052632,1.0,3.6653798586736794,5.13685650181214,6.638836153518129,3.9156992243077586,15,19,19,23,5,5,9,5,78,74,78,70,10,14,10,18,7,7,3,7
703,0.7999999999999999,0.8636363636363636,1.0,0.9117647058823529,0.9696969696969697,3.687402084808684,5.3845701093437475,7.157056797493352,4.002388464607299,22,13,34,33,5,9,9,9,71,84,63,64,17,4,25,24,7,3,3,3
704,0.7999999999999999,0.9444444444444444,0.9285714285714286,0.7857142857142857,0.9130434782608695,3.8421019089912067,5.701958028553436,6.790408104968589,3.9873451503648014,18,14,14,23,9,0,5,9,79,74,79,74,9,14,9,14,3,12,7,3
705,0.7999999999999999,0.7647058823529411,0.95,0.8571428571428571,0.9166666666666666,3.841053781144441,6.221823743269637,7.331416085726604,4.092381274329834,17,40,14,12,12,5,9,9,83,53,83,85,5,35,5,3,0,7,3,3
706,0.7999999999999999,0.7857142857142857,0.9166666666666666,0.9473684210526315,0.9285714285714286,3.7126308364844514,5.701696047045924,6.9642296473435845,3.8054392927256027,14,24,19,14,9,9,9,9,83,73,78,83,5,15,10,5,3,3,3,3
707,0.7999999999999999,0.8275862068965517,0.8947368421052632,0.7777777777777778,0.9444444444444444,3.677295046405314,4.91156342863422,6.663203221138896,3.793013280066112,29,19,18,18,5,5,9,9,64,74,79,79,24,14,9,9,7,7,3,3
708,0.7999999999999999,0.8518518518518519,0.9565217391304348,0.8888888888888888,0.9230769230769231,3.603063323702529,5.28774423538507,7.29516520966087,3.7096488401599874,27,23,9,26,12,8,9,12,73,73,88,74,15,15,0,14,0,4,3,0
709,0.7999999999999999,0.7777777777777778,0.8076923076923077,0.7894736842105263,0.9230769230769231,3.777512370287622,5.789072932061928,6.558166099532895,4.161042704114453,9,26,19,13,9,4,9,9,88,66,78,84,0,22,10,4,3,8,3,3
710,0.7999999999999999,0.7857142857142857,0.95,1.0,0.967741935483871,3.6633893614925457,5.3876025947160855,6.3354329223172305,4.0510930494277355,14,20,12,31,9,5,12,9,83,73,88,66,5,15,0,22,3,7,0,3
711,0.7999999999999999,0.8888888888888888,0.9230769230769231,0.8888888888888888,0.8125,3.5797599214822875,5.320145945816032,6.090871334117898,3.9106131842235867,9,13,9,32,9,9,9,12,88,84,88,68,0,4,0,20,3,3,3,0
712,0.7999999999999999,0.896551724137931,0.9545454545454546,0.8928571428571429,0.9230769230769231,3.7355119584184755,5.820154795822129,7.259903389830214,3.8718760915734234,29,44,28,39,12,12,9,12,71,56,69,61,17,32,19,27,0,0,3,0
713,0.7999999999999999,0.9,0.92,1.0,0.9333333333333333,3.8533676986071375,5.691747340685797,8.034646562574332,4.117239185839103,30,25,36,45,5,9,8,12,63,72,60,55,25,16,28,33,7,3,4,0
714,0.7999999999999999,0.6923076923076923,0.9,0.8518518518518519,0.8,3.7567880103455886,5.606033763204239,7.456344800140893,4.077423882715688,13,40,27,30,5,9,5,5,80,57,66,63,8,31,22,25,7,3,7,7
715,0.7999999999999999,0.8333333333333334,0.896551724137931,0.9473684210526315,0.8611111111111112,3.7067155927601796,5.8051754526846135,6.43090744284619,3.85887960505792,12,29,19,36,5,9,5,5,81,68,74,57,7,20,14,31,7,3,7,7
716,0.7999999999999999,0.75,1.0,0.7777777777777778,0.9,3.875094410493397,5.410156796510294,7.045791457775384,4.139217218033326,12,12,9,30,9,9,9,9,85,85,88,67,3,3,0,21,3,3,3,3
717,0.7999999999999999,0.6666666666666666,0.9333333333333333,1.0,0.8461538461538461,3.591828688446541,5.14878367720922,6.897475457382595,3.920106540280723,9,15,9,13,0,0,0,0,79,73,79,75,9,15,9,13,12,12,12,12
718,0.7999999999999999,0.9333333333333333,0.8947368421052632,0.85,0.9444444444444444,3.6795557378452863,5.959936402644996,7.084067339834002,3.8454200647708725,15,38,20,18,5,5,5,5,78,55,73,75,10,33,15,13,7,7,7,7
719,0.7999999999999999,1.0,0.8620689655172413,0.9310344827586207,1.0,3.661834664463182,5.577153343884029,7.297553860226645,3.742115460637394,17,29,29,27,9,9,12,9,80,68,71,70,8,20,17,18,3,3,0,3
720,0.7999999999999999,0.8,1.0,0.9,0.8648648648648649,3.5068751029513137,5.1698410952496,5.98960354467893,3.6126335649999395,15,16,20,37,5,8,5,8,78,80,73,59,10,8,15,29,7,4,7,4
721,0.7999999999999999,0.75,0.875,0.5,0.7857142857142857,3.7416554104886313,5.605406991486596,6.489664774731864,3.9750470835292044,8,8,8,28,8,8,8,8,88,88,88,68,0,0,0,20,4,4,4,4
722,0.7999999999999999,0.868421052631579,0.8695652173913043,0.9137931034482759,0.84,3.737719322471976,5.463041008536842,7.048240465468222,3.716044464863789,38,23,58,50,12,12,12,12,62,77,42,50,26,11,46,38,0,0,0,0
723,0.7999999999999999,0.8333333333333334,0.8461538461538461,1.0,0.967741935483871,3.7911115311984713,5.633421504699067,6.950942535333906,4.0793747638167925,12,26,10,31,8,12,5,8,84,74,83,65,4,14,5,23,4,0,7,4
724,0.7999999999999999,0.9,1.0,0.8,0.9591836734693877,3.7620390039043814,5.241612680939331,6.966882234703084,4.100248345514139,10,12,30,49,5,9,5,12,83,85,63,51,5,3,25,37,7,3,7,0
725,0.7999999999999999,0.9565217391304348,0.9545454545454546,0.96,0.9696969696969697,3.7360503540986074,5.608917300177823,6.884280348178563,3.845433277223214,23,22,25,33,9,9,12,9,74,75,75,64,14,13,13,24,3,3,0,3
726,0.7999999999999999,0.9090909090909091,0.9166666666666666,0.8571428571428571,0.9333333333333333,3.821210101911477,5.169780524309592,7.634297355038017,4.116829865188517,11,12,7,30,8,8,3,8,85,84,84,66,3,4,4,22,4,4,9,4
727,0.7999999999999999,0.84375,0.9302325581395349,0.9130434782608695,0.9230769230769231,3.6164435225618448,5.422494119872081,6.923778107770595,3.6922726298327357,32,43,23,52,5,5,5,5,61,50,70,41,27,38,18,47,7,7,7,7
728,0.7999999999999999,1.0,1.0,1.0,0.9565217391304348,3.535341325861583,5.903690930220099,6.180166046374149,3.8263536499451365,5,29,15,23,5,5,12,9,88,64,85,74,0,24,3,14,7,7,0,3
729,0.7999999999999999,0.8571428571428571,0.8863636363636364,0.8888888888888888,0.8823529411764706,3.598412239737569,6.146892696932738,6.198831392631451,3.8881827866771754,14,44,9,17,5,5,9,9,79,49,88,80,9,39,0,8,7,7,3,3
730,0.7999999999999999,0.9473684210526315,0.9166666666666666,0.96,0.896551724137931,3.6563725033714016,5.472211237912409,7.2972003570770765,3.8077998054775186,19,24,25,29,9,9,5,9,78,73,68,68,10,15,20,20,3,3,7,3
731,0.7999999999999999,0.6521739130434783,0.875,0.8695652173913043,0.8076923076923077,3.6989717048626396,5.529076389271604,7.000565145706822,3.983723875119443,23,24,23,26,8,9,8,7,73,73,73,69,15,15,15,19,4,3,4,5
732,0.7999999999999999,0.8108108108108109,0.9130434782608695,0.967741935483871,0.8169014084507042,3.834189318184619,5.4762639332415,7.2494936200276054,3.896882638736728,37,46,31,71,9,9,5,9,60,51,62,26,28,37,26,62,3,3,7,3
733,0.7999999999999999,0.75,1.0,0.9166666666666666,0.9545454545454546,3.5459511820066396,5.4254948119597195,6.1314746299591825,3.861837929950812,8,18,12,22,8,8,12,5,88,78,88,71,0,10,0,17,4,4,0,7
734,0.7999999999999999,0.75,0.8571428571428571,0.875,0.7916666666666666,3.611836706026936,5.5244353715937615,6.995848273570409,3.7629654471097704,28,21,24,24,9,5,9,9,69,72,73,73,19,16,15,15,3,7,3,3
735,0.7999999999999999,0.8421052631578947,0.8928571428571429,0.7368421052631579,0.8636363636363636,3.7491526585694483,5.623353971673432,6.600192840913253,3.916429927215113,19,28,19,22,9,9,9,12,78,69,78,78,10,19,10,10,3,3,3,0
736,0.7999999999999999,0.875,0.9375,1.0,0.9642857142857143,3.743289182477855,5.909864528677251,6.655879517941722,3.7780754580409193,8,48,8,28,8,8,8,8,88,48,88,68,0,40,0,20,4,4,4,4
737,0.7999999999999999,0.8260869565217391,0.8958333333333334,0.8947368421052632,1.0,3.7531468499797427,5.983516422163649,6.889589705665427,3.988393958486863,23,48,19,33,9,12,9,9,74,52,78,64,14,36,10,24,3,0,3,3
738,0.7999999999999999,0.6428571428571429,0.7647058823529411,0.8387096774193549,0.8571428571428571,3.620599255964469,5.053408196411276,7.0344206359188854,3.8065770238675163,14,17,31,28,9,9,9,9,83,80,66,69,5,8,22,19,3,3,3,3
739,0.7999999999999999,1.0,0.9230769230769231,0.7857142857142857,0.9411764705882353,3.960115496306118,6.205489519856391,6.58256015213895,4.224486211296666,9,39,14,34,9,9,9,9,88,58,83,63,0,30,5,25,3,3,3,3
740,0.7999999999999999,0.9166666666666666,0.8888888888888888,0.9375,0.9259259259259259,3.695117338512645,5.3429922832069785,6.514967103757346,3.9935037979737356,12,18,16,27,5,5,9,9,81,75,81,70,7,13,7,18,7,7,3,3
741,0.7999999999999999,0.8888888888888888,0.9130434782608695,0.9333333333333333,0.875,3.711285220946218,5.892896286403564,6.5820031601750015,3.8954871359782786,9,46,15,32,9,9,5,9,88,51,78,65,0,37,10,23,3,3,7,3
742,0.7999999999999999,0.8947368421052632,0.8333333333333334,0.8928571428571429,1.0,3.790799885685895,5.559908802166123,6.492029126742118,3.9384188870464527,19,30,28,13,4,12,4,4,73,70,64,79,15,18,24,9,8,0,8,8
743,0.7999999999999999,0.6428571428571429,0.9142857142857143,0.9,0.9302325581395349,3.743167918793694,5.818046879319117,7.094394326428086,3.962496999547088,14,35,20,43,9,5,5,9,83,58,73,54,5,30,15,34,3,7,7,3
744,0.7999999999999999,0.75,0.8333333333333334,0.8148148148148148,0.8431372549019608,3.7665235397050894,5.804788456396857,7.018576734426989,3.96281592879004,24,36,27,51,9,9,9,9,73,61,70,46,15,27,18,42,3,3,3,3
745,0.7999999999999999,0.8695652173913043,0.8666666666666667,0.8571428571428571,0.8627450980392157,4.008527438493809,5.919224589785331,7.118884214275503,4.256757769083022,23,30,14,51,9,5,0,12,74,63,74,49,14,25,14,39,3,7,12,0
746,0.7999999999999999,0.8421052631578947,0.8947368421052632,0.9473684210526315,0.8928571428571429,3.7943032438404285,5.549544165271198,7.212324580901006,4.0593883432772255,19,19,19,28,9,5,9,9,78,74,78,69,10,14,10,19,3,7,3,3
747,0.7999999999999999,0.8888888888888888,1.0,0.6666666666666666,0.8888888888888888,3.7158880318850773,5.520875435354878,6.376795921064095,4.09815097524849,9,24,9,63,9,9,9,9,88,73,88,34,0,15,0,54,3,3,3,3
748,0.7999999999999999,1.0,1.0,0.8,1.0,3.64970388890589,5.067658564934236,6.2205518968624345,4.02118586172369,5,10,5,18,5,5,5,5,88,83,88,75,0,5,0,13,7,7,7,7
749,0.7999999999999999,0.8947368421052632,0.9285714285714286,0.8,0.8333333333333334,3.787720956319869,5.409169064114026,6.1086933867463795,4.041207405269609,19,28,5,24,9,9,5,9,78,69,88,73,10,19,0,15,3,3,7,3
750,0.7999999999999999,0.9166666666666666,0.7857142857142857,0.9655172413793104,0.9354838709677419,3.7793609963545003,5.350001226505844,8.113748188420624,4.03555800955108,24,14,29,31,9,9,9,8,73,83,68,65,15,5,20,23,3,3,3,4
751,0.7999999999999999,0.8181818181818182,0.8235294117647058,0.8333333333333334,0.8043478260869565,3.8140876426192722,5.415232860323275,7.215730246917135,3.8897900811195747,22,17,24,46,9,9,12,12,75,80,76,54,13,8,12,34,3,3,0,0
752,0.7999999999999999,0.7931034482758621,0.8448275862068966,0.9318181818181818,0.9038461538461539,3.7527403413247367,5.9632008641339205,7.209710243840015,3.8416178986378116,29,58,44,52,9,12,9,9,68,42,53,45,20,46,35,43,3,0,3,3
753,0.7999999999999999,0.7142857142857143,0.9166666666666666,0.9285714285714286,0.8888888888888888,3.6227757866256214,5.252116744162323,6.72661666586625,3.854814207690004,14,24,14,18,9,9,9,9,83,73,83,79,5,15,5,9,3,3,3,3
754,0.7999999999999999,0.8461538461538461,0.875,0.9,0.8888888888888888,3.6398407568656452,5.392259182933022,7.221895182070179,3.894088607280069,13,16,10,27,9,9,5,12,84,81,83,73,4,7,5,15,3,3,7,0
755,0.7999999999999999,0.7333333333333333,0.7894736842105263,0.8,0.918918918918919,3.622932137918537,5.292284021922268,7.073724574367961,3.9419946899889116,15,19,10,37,5,5,0,12,78,74,78,63,10,14,10,25,7,7,12,0
756,0.7999999999999999,1.0,0.9285714285714286,0.7777777777777778,1.0,3.8964357803862675,6.053816771655889,6.967087307570311,4.360132493502018,9,28,9,30,9,8,5,9,88,68,84,67,0,20,4,21,3,4,7,3
757,0.7999999999999999,0.7777777777777778,0.9375,0.8846153846153846,0.8157894736842105,3.571119344357557,4.912441161346942,6.604678001444584,3.886856457481983,27,16,26,38,12,12,8,12,73,84,70,62,15,4,18,26,0,0,4,0
758,0.7999999999999999,0.875,0.8974358974358975,0.8571428571428571,0.9411764705882353,3.4670816828007496,5.578830122855998,6.12150539757287,3.4812699735505714,24,39,28,34,9,9,9,9,73,58,69,63,15,30,19,25,3,3,3,3
759,0.7999999999999999,0.8235294117647058,0.8333333333333334,0.8823529411764706,1.0,3.5886341863525364,5.745464778336427,6.831634040045844,3.8792103517560785,17,48,17,34,8,8,8,5,79,48,79,59,9,40,9,29,4,4,4,7
760,0.7999999999999999,0.8571428571428571,0.8529411764705882,1.0,0.9411764705882353,3.470766803839561,5.234029036114596,6.983749481064275,3.640928954107052,14,34,9,34,9,9,9,5,83,63,88,59,5,25,0,29,3,3,3,7
761,0.7999999999999999,0.6666666666666666,0.8947368421052632,1.0,0.9285714285714286,3.687298028570136,5.257254189968162,6.863649213637135,4.101587910699207,15,19,11,14,5,12,5,8,78,81,82,82,10,7,6,6,7,0,7,4
762,0.7999999999999999,0.9166666666666666,0.9090909090909091,1.0,0.8823529411764706,3.807789193346837,6.068079934074063,7.372001375408641,3.953087435492258,12,22,5,17,9,9,5,9,85,75,88,80,3,13,0,8,3,3,7,3
763,0.7999999999999999,0.8846153846153846,0.972972972972973,0.9047619047619048,0.9130434782608695,3.6716172399427527,5.525644935195427,6.315766787948531,3.890952025731309,26,37,21,46,5,9,5,5,67,60,72,47,21,28,16,41,7,3,7,7
764,0.7999999999999999,0.9285714285714286,0.6666666666666666,0.9444444444444444,0.9285714285714286,3.83299068878708,5.318395989782531,7.83105091835645,4.021332081811871,14,12,18,14,9,9,12,9,83,85,82,83,5,3,6,5,3,3,0,3
765,0.7999999999999999,0.875,0.8,0.7391304347826086,0.896551724137931,3.7661824500577055,5.342218110325684,6.671066730329405,4.088179020925833,8,5,23,29,8,5,5,5,88,88,70,64,0,0,18,24,4,7,7,7
766,0.7999999999999999,0.7142857142857143,1.0,1.0,1.0,3.697442752282409,5.413499036230685,7.326173442593995,3.9901386017425864,14,14,22,18,9,9,12,4,83,83,78,74,5,5,10,14,3,3,0,8
767,0.7999999999999999,0.8571428571428571,0.8947368421052632,1.0,0.9655172413793104,3.960733305775702,5.9954107402622885,7.082032204562533,4.300173129342234,21,19,10,29,5,9,5,5,72,78,83,64,16,10,5,24,7,3,7,7
768,0.7999999999999999,0.8461538461538461,0.9629629629629629,1.0,0.967741935483871,3.6619412153255415,5.457436639153629,6.429871545208148,3.931986190014249,13,27,15,31,9,5,5,9,84,66,78,66,4,22,10,22,3,7,7,3
769,0.7999999999999999,0.8,0.5,0.8,0.9166666666666666,3.8932122068854227,5.785938241663972,6.827448438679511,4.470151710099523,5,4,5,12,5,0,5,8,88,84,88,84,0,4,0,4,7,12,7,4
770,0.7999999999999999,0.8235294117647058,0.7777777777777778,1.0,0.9655172413793104,3.7726524502428003,5.411002228026696,6.792138362294849,4.016320038870507,17,9,9,29,9,4,9,9,80,83,88,68,8,5,0,20,3,8,3,3
771,0.7999999999999999,0.8181818181818182,1.0,0.8461538461538461,0.8888888888888888,3.879258391955331,5.551122486933887,7.242850850213856,4.178135050874688,22,21,13,27,9,9,9,9,75,76,84,70,13,12,4,18,3,3,3,3
772,0.7999999999999999,0.9,0.9285714285714286,1.0,0.92,3.6810073585807315,5.852311470333377,6.813442289144635,4.168410735650564,10,28,5,25,5,9,5,5,83,69,88,68,5,19,0,20,7,3,7,7
773,0.7999999999999999,0.9,0.92,1.0,0.90625,3.7501168150870234,5.331148040237626,6.951980272899864,3.9209531271156557,10,25,5,32,5,12,5,9,83,75,88,65,5,13,0,23,7,0,7,3
774,0.7999999999999999,0.7777777777777778,0.9230769230769231,0.7777777777777778,0.9444444444444444,3.4844173253660427,4.949820750875684,5.858013007506761,3.7518724233434124,9,13,9,36,9,9,9,12,88,84,88,64,0,4,0,24,3,3,3,0
775,0.7999999999999999,0.8461538461538461,0.918918918918919,0.7272727272727273,0.8888888888888888,3.8183798324321137,6.146154212969413,6.533664660357974,4.212024978251027,13,37,11,27,9,9,3,9,84,60,80,70,4,28,8,18,3,3,9,3
776,0.7999999999999999,1.0,0.9583333333333334,0.9411764705882353,0.9166666666666666,3.5278186189981047,5.34740265686957,6.876604490774084,3.9326734930362135,9,24,17,48,9,9,7,9,88,73,78,49,0,15,10,39,3,3,5,3
777,0.7999999999999999,0.7619047619047619,0.9032258064516129,1.0,0.918918918918919,3.5860795850704443,5.567000626254309,7.3026435513964785,3.863411142716319,21,31,19,37,9,9,9,8,76,66,78,59,12,22,10,29,3,3,3,4
778,0.7999999999999999,0.9411764705882353,0.9333333333333333,0.9411764705882353,0.9666666666666667,3.4568111944717606,5.1853589061884096,5.622921044986446,3.6998867142359155,17,15,17,30,9,5,9,9,80,78,80,67,8,10,8,21,3,7,3,3
779,0.7999999999999999,0.5882352941176471,0.9705882352941176,0.7083333333333334,0.8571428571428571,3.9226366154723724,6.235049441040834,7.444341282712294,4.118012458720291,17,34,24,21,9,9,12,8,80,63,76,75,8,25,12,13,3,3,0,4
780,0.7999999999999999,0.9166666666666666,0.85,0.9473684210526315,0.918918918918919,3.555622142814782,5.1680994625751335,7.015964988107389,3.862052550481851,12,20,19,37,9,5,5,9,85,73,74,60,3,15,14,28,3,7,7,3
781,0.7999999999999999,0.75,0.9090909090909091,1.0,0.9473684210526315,3.797269552538058,6.104831502439233,7.00642804639071,4.118999342448478,12,44,12,19,9,9,12,9,85,53,88,78,3,35,0,10,3,3,0,3
782,0.7999999999999999,0.8421052631578947,0.9473684210526315,0.8695652173913043,0.9090909090909091,3.495796266744235,4.951820310823724,6.3841239450453795,3.6350296854965123,19,19,23,22,9,5,9,12,78,74,74,78,10,14,14,10,3,7,3,0
783,0.7999999999999999,0.7894736842105263,0.8333333333333334,0.8333333333333334,0.8666666666666667,3.769150556648301,5.546722651454665,6.586065744197904,3.9351398171879124,19,18,18,45,9,4,8,12,78,74,78,55,10,14,10,33,3,8,4,0
784,0.7999999999999999,0.6923076923076923,0.8888888888888888,0.8888888888888888,0.8461538461538461,3.644156092774886,5.308958042227521,6.748447423153539,4.013132970658704,13,18,9,13,9,9,4,9,84,79,83,84,4,9,5,4,3,3,8,3
785,0.7999999999999999,0.8823529411764706,0.9130434782608695,0.9629629629629629,0.8928571428571429,3.75132299666841,5.973922671781417,7.813315587103475,3.7947860848979458,17,23,27,28,9,9,9,9,80,74,70,69,8,14,18,19,3,3,3,3
786,0.7999999999999999,0.7692307692307693,1.0,0.7692307692307693,0.9166666666666666,3.6278160546966585,4.869081636100132,6.220960262827602,3.872828396948887,13,5,13,24,5,5,5,5,80,88,80,69,8,0,8,19,7,7,7,7
787,0.7999999999999999,0.9333333333333333,0.7777777777777778,0.9333333333333333,0.8666666666666667,3.691123899147897,5.3036021128978215,7.1508542482807576,3.880531067533839,15,36,30,45,5,12,12,12,78,64,70,55,10,24,18,33,7,0,0,0
788,0.7999999999999999,0.8888888888888888,0.8636363636363636,1.0,0.9090909090909091,3.6123111938055223,5.143031735587737,7.098756550941249,3.8119413880940516,9,22,9,22,9,9,9,12,88,75,88,78,0,13,0,10,3,3,3,0
789,0.7999999999999999,0.8421052631578947,0.9666666666666667,0.8695652173913043,0.9166666666666666,3.753009235276369,5.775553570717481,6.836117079009998,3.9113588930570895,19,30,23,36,9,12,9,9,78,70,74,61,10,18,14,27,3,0,3,3
790,0.7999999999999999,0.84375,0.9259259259259259,0.7777777777777778,0.875,3.830324524715066,5.92259931223158,6.497197351693182,4.060995753830786,32,27,9,32,9,9,9,9,65,70,88,65,23,18,0,23,3,3,3,3
791,0.7999999999999999,0.7083333333333334,0.8695652173913043,0.875,0.8947368421052632,3.574960229810781,5.584742457887114,6.90306508714959,3.7833626433725995,24,23,32,38,9,9,8,5,73,74,64,55,15,14,24,33,3,3,4,7
792,0.7999999999999999,0.7692307692307693,0.9347826086956522,0.7777777777777778,0.9375,3.4757403786037027,5.436374170649037,6.3570843778068005,3.6368225470790825,13,46,18,48,8,8,8,8,83,50,78,48,5,38,10,40,4,4,4,4
793,0.7999999999999999,0.8,1.0,1.0,0.9230769230769231,3.6125786222097522,5.2183170428760155,6.480302453152831,4.033829742692219,5,8,10,13,5,5,5,9,88,85,83,84,0,3,5,4,7,7,7,3
794,0.7999999999999999,0.625,0.7647058823529411,1.0,0.9411764705882353,3.8366021488958824,5.376483200663763,7.521294691228495,4.176601492890996,16,17,18,17,9,5,5,9,81,76,75,80,7,12,13,8,3,7,7,3
795,0.7999999999999999,0.6666666666666666,0.8205128205128205,0.8787878787878788,0.8409090909090909,3.5892246066262192,5.541666233087846,6.545722184081834,3.6595159661330126,36,39,33,44,9,9,12,9,61,58,67,53,27,30,21,35,3,3,0,3
796,0.7999999999999999,0.8461538461538461,0.8928571428571429,0.90625,0.9038461538461539,3.637350683044413,5.461088544163211,6.944311598218527,3.7484880326620202,26,28,32,52,12,9,12,12,74,69,68,48,14,19,20,40,0,3,0,0
797,0.7999999999999999,0.8888888888888888,0.8648648648648649,0.9583333333333334,0.9285714285714286,3.46119664024165,5.547640757692736,6.580293020835197,3.6536451290767085,9,37,24,42,9,4,9,9,88,55,73,55,0,33,15,33,3,8,3,3
798,0.7999999999999999,0.7666666666666667,0.7428571428571429,0.7941176470588235,0.8387096774193549,3.817726715484786,5.4600807592664085,6.725328674321575,3.8069932191031395,30,35,34,31,7,9,7,4,65,62,61,61,23,26,27,27,5,3,5,8
799,0.7999999999999999,0.6923076923076923,0.9130434782608695,1.0,0.8837209302325582,3.7281309115091052,5.228767347874831,7.263810312435049,4.182848848472446,13,23,24,43,9,9,9,12,84,74,73,57,4,14,15,31,3,3,3,0
800,0.8999999999999999,0.75,0.8518518518518519,0.75,0.9,3.683027514455137,5.605704898487978,7.010104766006769,3.8513557334501702,16,27,16,50,9,9,9,9,81,70,81,47,7,18,7,41,3,3,3,3
801,0.8999999999999999,0.7391304347826086,0.9130434782608695,0.8333333333333334,0.9722222222222222,3.6785176014816408,5.585124756636874,6.588533293996904,3.847881143044731,23,23,24,36,9,9,9,12,74,74,73,64,14,14,15,24,3,3,3,0
802,0.8999999999999999,0.8421052631578947,0.9473684210526315,0.8947368421052632,1.0,3.668922311502195,5.142793475225641,6.63945831183775,3.921267951088603,19,19,19,23,9,5,9,5,78,74,78,70,10,14,10,18,3,7,3,7
803,0.8999999999999999,0.8636363636363636,1.0,0.9117647058823529,0.9393939393939394,3.691373785228645,5.386110122356901,7.157289393579468,4.04029394332323,22,13,34,33,5,9,9,9,71,84,63,64,17,4,25,24,7,3,3,3
804,0.8999999999999999,0.9444444444444444,0.9285714285714286,0.7857142857142857,0.9130434782608695,3.841855353253026,5.720793410312894,6.796664852270973,4.0570778604338535,18,14,14,23,9,0,5,9,79,74,79,74,9,14,9,14,3,12,7,3
805,0.8999999999999999,0.7647058823529411,0.95,0.8571428571428571,0.9166666666666666,3.841053781144441,6.234916463397411,7.331041330311981,4.064564315668315,17,40,14,12,12,5,9,9,83,53,83,85,5,35,5,3,0,7,3,3
806,0.8999999999999999,0.7857142857142857,0.9166666666666666,0.9473684210526315,0.9285714285714286,3.712972081954629,5.702535329739793,6.963483481979058,3.7970402083633106,14,24,19,14,9,9,9,9,83,73,78,83,5,15,10,5,3,3,3,3
807,0.8999999999999999,0.8275862068965517,0.8947368421052632,0.7777777777777778,0.9444444444444444,3.6804681120522154,4.917312058347682,6.66437167539028,3.7441271866226677,29,19,18,18,5,5,9,9,64,74,79,79,24,14,9,9,7,7,3,3
808,0.8999999999999999,0.8518518518518519,0.9565217391304348,0.8888888888888888,0.9230769230769231,3.603063323702529,5.29490585477136,7.2966092734222,3.669096304443992,27,23,9,26,12,8,9,12,73,73,88,74,15,15,0,14,0,4,3,0
809,0.8999999999999999,0.8333333333333334,0.8076923076923077,0.7894736842105263,0.9230769230769231,3.8214603946296966,5.807231689005123,6.55947214810297,3.97372871499266,12,26,19,13,9,4,9,9,85,66,78,84,3,22,10,4,3,8,3,3
810,0.8999999999999999,0.7857142857142857,0.95,1.0,0.9032258064516129,3.663751005085014,5.395016100271976,6.3354329223172305,3.801440241564058,14,20,12,31,9,5,12,9,83,73,88,66,5,15,0,22,3,7,0,3
811,0.8999999999999999,0.8888888888888888,0.9230769230769231,0.8888888888888888,0.8125,3.5801316226034223,5.321129711248152,6.092693024431101,3.904027921196052,9,13,9,32,9,9,9,12,88,84,88,68,0,4,0,20,3,3,3,0
812,0.8999999999999999,0.896551724137931,0.9545454545454546,0.8928571428571429,0.9487179487179487,3.735511958418476,5.820154795822129,7.263002461061637,3.906046819993791,29,44,28,39,12,12,9,12,71,56,69,61,17,32,19,27,0,0,3,0
813,0.8999999999999999,0.9,0.92,1.0,0.9333333333333333,3.8565350262381637,5.693192611804618,8.042835197726609,3.975227931143718,30,25,36,45,5,9,8,12,63,72,60,55,25,16,28,33,7,3,4,0
814,0.8999999999999999,0.6923076923076923,0.9,0.8518518518518519,0.8,3.758773676245866,5.607373702974624,7.45952002863621,4.075286677274705,13,40,27,30,5,9,5,5,80,57,66,63,8,31,22,25,7,3,7,7
815,0.8999999999999999,0.8333333333333334,0.896551724137931,0.9473684210526315,0.8888888888888888,3.7091832554716553,5.805414032521921,6.440221255858377,3.8705857713304663,12,29,19,36,5,9,5,5,81,68,74,57,7,20,14,31,7,3,7,7
816,0.8999999999999999,0.75,1.0,0.7777777777777778,0.9333333333333333,3.875266747173701,5.410288930368274,7.04707863210221,4.181655621639799,12,12,9,30,9,9,9,9,85,85,88,67,3,3,0,21,3,3,3,3
817,0.8999999999999999,0.6666666666666666,0.9333333333333333,1.0,0.8461538461538461,3.597826929876609,5.1631456391738055,6.916629919161175,3.919390562812895,9,15,9,13,0,0,0,0,79,73,79,75,9,15,9,13,12,12,12,12
818,0.8999999999999999,0.9333333333333333,0.8947368421052632,0.85,0.9444444444444444,3.6824038302143554,5.964513433566948,7.093989607084022,3.8435018600303863,15,38,20,18,5,5,5,5,78,55,73,75,10,33,15,13,7,7,7,7
819,0.8999999999999999,1.0,0.8620689655172413,0.9310344827586207,0.9629629629629629,3.6628845933848715,5.5788369765258325,7.297553860226645,3.871943334821321,17,29,29,27,9,9,12,9,80,68,71,70,8,20,17,18,3,3,0,3
820,0.8999999999999999,0.8,1.0,0.9,0.8648648648648649,3.569599147168226,5.1745469814772616,5.995276336735074,3.611523262014899,25,16,20,37,5,8,5,8,68,80,73,59,20,8,15,29,7,4,7,4
821,0.8999999999999999,0.75,0.8823529411764706,0.625,0.7857142857142857,3.743760976077523,5.7624324172097445,6.4937800127490135,3.975850224102063,8,17,8,28,8,8,8,8,88,79,88,68,0,9,0,20,4,4,4,4
822,0.8999999999999999,0.868421052631579,0.8695652173913043,0.9137931034482759,0.84,3.737719322471976,5.463041008536842,7.048240465468222,3.895386828826982,38,23,58,50,12,12,12,12,62,77,42,50,26,11,46,38,0,0,0,0
823,0.8999999999999999,0.8125,0.8461538461538461,1.0,0.9428571428571428,3.809659455538265,5.633421504699067,6.959966335298743,4.106536267199729,16,26,10,35,12,12,5,12,84,74,83,65,4,14,5,23,0,0,7,0
824,0.8999999999999999,0.9,1.0,0.8235294117647058,0.9387755102040817,3.7652798252401203,5.2425250218749655,7.146186162415399,3.982861895236124,10,12,34,49,5,9,9,12,83,85,63,51,5,3,25,37,7,3,3,0
825,0.8999999999999999,0.9565217391304348,0.9545454545454546,0.96,1.0,3.7368338202632727,5.610414856217859,6.8842803481785655,3.8284469319156536,23,22,25,33,9,9,12,9,74,75,75,64,14,13,13,24,3,3,0,3
826,0.8999999999999999,0.9090909090909091,0.9166666666666666,0.8333333333333334,0.8666666666666667,3.8223742971595005,5.173668299337561,7.1460096751306,4.0630560600132375,11,12,12,30,8,8,8,8,85,84,84,66,3,4,4,22,4,4,4,4
827,0.8999999999999999,0.84375,0.9302325581395349,0.9130434782608695,0.9038461538461539,3.6181861472844803,5.4252612454714315,6.926992929818881,3.7259364207404797,32,43,23,52,5,5,5,5,61,50,70,41,27,38,18,47,7,7,7,7
828,0.8999999999999999,1.0,1.0,1.0,0.9696969696969697,3.538176238367965,5.912785462189289,6.180166046374149,4.213736064308139,5,29,15,33,5,5,12,9,88,64,85,64,0,24,3,24,7,7,0,3
829,0.8999999999999999,0.8571428571428571,0.8863636363636364,0.8888888888888888,0.8823529411764706,3.6016649156533402,6.15136552998757,6.200410361390045,3.874497813127173,14,44,9,17,5,5,9,9,79,49,88,80,9,39,0,8,7,7,3,3
830,0.8999999999999999,0.9473684210526315,0.9166666666666666,0.96,0.896551724137931,3.6564546315092876,5.4712712704072,7.30758027894886,3.801747052238389,19,24,25,29,9,9,5,9,78,73,68,68,10,15,20,20,3,3,7,3
831,0.8999999999999999,0.6521739130434783,0.875,0.8695652173913043,0.8076923076923077,3.6993699501713624,5.530429335205729,7.002260880402279,3.9007578649418595,23,24,23,26,8,9,8,7,73,73,73,69,15,15,15,19,4,3,4,5
832,0.8999999999999999,0.8108108108108109,0.9130434782608695,0.967741935483871,0.8169014084507042,3.8342501820459023,5.4760165267135505,7.255227984564972,3.8954843200606817,37,46,31,71,9,9,5,9,60,51,62,26,28,37,26,62,3,3,7,3
833,0.8999999999999999,0.75,1.0,0.9166666666666666,0.9545454545454546,3.5475427318673702,5.429490599961345,6.1314746299591825,3.861510703907479,8,18,12,22,8,8,12,5,88,78,88,71,0,10,0,17,4,4,0,7
834,0.8999999999999999,0.75,0.8571428571428571,0.875,0.875,3.6118136856472787,5.531048224617058,6.9960081336618325,3.781844198055732,28,21,24,24,9,5,9,9,69,72,73,73,19,16,15,15,3,7,3,3
835,0.8999999999999999,0.8421052631578947,0.8928571428571429,0.7368421052631579,0.8636363636363636,3.7494373168613913,5.6241243031198,6.602341950894531,3.9112659064571345,19,28,19,22,9,9,9,12,78,69,78,78,10,19,10,10,3,3,3,0
836,0.8999999999999999,0.875,0.9375,1.0,0.8928571428571429,3.746252999076404,5.913138495625703,6.660136608652201,3.838362460645327,8,48,8,28,8,8,8,8,88,48,88,68,0,40,0,20,4,4,4,4
837,0.8999999999999999,0.8260869565217391,0.8958333333333334,0.8947368421052632,0.9696969696969697,3.7536086105974062,5.983516422163649,6.891042563856878,4.036924992181476,23,48,19,33,9,12,9,9,74,52,78,64,14,36,10,24,3,0,3,3
838,0.8999999999999999,0.6428571428571429,0.7647058823529411,0.8387096774193549,0.8928571428571429,3.6207499137245245,5.053943562221932,7.033024298547892,3.780234968761037,14,17,31,28,9,9,9,9,83,80,66,69,5,8,22,19,3,3,3,3
839,0.8999999999999999,1.0,0.9230769230769231,0.7857142857142857,0.9411764705882353,3.960496885036346,6.2059787548333025,6.582966338856409,4.2157702155061285,9,39,14,34,9,9,9,9,88,58,83,63,0,30,5,25,3,3,3,3
840,0.8999999999999999,0.9375,0.8888888888888888,0.9375,0.9629629629629629,3.736918288615126,5.348801951329682,6.516180816379236,4.062653324527551,16,18,16,27,9,5,9,9,81,75,81,70,7,13,7,18,3,7,3,3
841,0.8999999999999999,0.9166666666666666,0.9130434782608695,0.9333333333333333,0.875,3.6766795473202127,5.8952780576803265,6.598492883549697,3.891938204686257,12,46,15,32,12,9,5,9,88,51,78,65,0,37,10,23,0,3,7,3
842,0.8999999999999999,0.9166666666666666,0.8333333333333334,0.8928571428571429,1.0,3.78827739652553,5.559908802166122,6.508971621007886,3.935176865620989,24,30,28,13,9,12,4,4,73,70,64,79,15,18,24,9,3,0,8,8
843,0.8999999999999999,0.6428571428571429,0.9142857142857143,0.9,0.9302325581395349,3.742851190184754,5.819471011102557,7.092285640128412,3.9608435817983803,14,35,20,43,9,5,5,9,83,58,73,54,5,30,15,34,3,7,7,3
844,0.8999999999999999,0.75,0.8333333333333334,0.8148148148148148,0.8823529411764706,3.7669857416023738,5.806292149682486,7.020954593005207,4.0412018096657425,24,36,27,51,9,9,9,9,73,61,70,46,15,27,18,42,3,3,3,3
845,0.8999999999999999,0.8695652173913043,0.8666666666666667,0.8421052631578947,0.9019607843137255,4.00904899604128,5.9260936479174555,7.047735950334363,4.087087107943062,23,30,19,51,9,5,5,12,74,63,74,49,14,25,14,39,3,7,7,0
846,0.8999999999999999,0.8421052631578947,0.8947368421052632,0.9473684210526315,0.8928571428571429,3.794308694366758,5.554701918137558,7.211251390494865,4.056213466482633,19,19,19,28,9,5,9,9,78,74,78,69,10,14,10,19,3,7,3,3
847,0.8999999999999999,0.8888888888888888,1.0,0.6666666666666666,0.8888888888888888,3.7163544098723134,5.521963514555434,6.3787689269589265,3.951004035935504,9,24,9,63,9,9,9,9,88,73,88,34,0,15,0,54,3,3,3,3
848,0.8999999999999999,1.0,1.0,0.8,1.0,3.650773609536209,5.069413401343494,6.223983852800112,3.9032596470950724,5,10,5,18,5,5,5,5,88,83,88,75,0,5,0,13,7,7,7,7
849,0.8999999999999999,0.8947368421052632,0.9285714285714286,0.8,0.8333333333333334,3.7876077376228436,5.409488625377331,6.111226086395606,4.0369535855676455,19,28,5,24,9,9,5,9,78,69,88,73,10,19,0,15,3,3,7,3
850,0.8999999999999999,0.9166666666666666,0.7857142857142857,0.9655172413793104,0.967741935483871,3.7798402959568556,5.350481534183722,8.113878305482672,4.0326040039384505,24,14,29,31,9,9,9,8,73,83,68,65,15,5,20,23,3,3,3,4
851,0.8999999999999999,0.8,0.8823529411764706,0.8333333333333334,0.8043478260869565,3.8378186490564894,5.416896609669209,7.215730246917135,3.88698876094485,25,17,24,46,12,9,12,12,75,80,76,54,13,8,12,34,0,3,0,0
852,0.8999999999999999,0.7931034482758621,0.8448275862068966,0.9318181818181818,0.8076923076923077,3.7528819329164147,5.9632008641339205,7.210333004871225,3.8125863663641706,29,58,44,52,9,12,9,9,68,42,53,45,20,46,35,43,3,0,3,3
853,0.8999999999999999,0.7142857142857143,0.9166666666666666,0.9285714285714286,0.8888888888888888,3.623126922682787,5.252874394141785,6.726991783033211,3.8419916817237914,14,24,14,18,9,9,9,9,83,73,83,79,5,15,5,9,3,3,3,3
854,0.8999999999999999,0.8461538461538461,0.875,0.9,0.8888888888888888,3.6403876343135377,5.3930846431737605,7.2274294063285,3.890342813666302,13,16,10,27,9,9,5,12,84,81,83,73,4,7,5,15,3,3,7,0
855,0.8999999999999999,0.7333333333333333,0.7894736842105263,0.8,0.918918918918919,3.6225459383532264,5.290142128305004,7.103936520856071,3.937935641407978,15,19,10,37,5,5,0,12,78,74,78,63,10,14,10,25,7,7,12,0
856,0.8999999999999999,1.0,0.9285714285714286,0.7777777777777778,1.0,3.8968800336048943,6.060005730273024,6.9721286089948675,4.356492787331693,9,28,9,30,9,8,5,9,88,68,84,67,0,20,4,21,3,4,7,3
857,0.8999999999999999,0.7777777777777778,0.9375,0.8846153846153846,0.8157894736842105,3.5711193443575575,4.912441161346942,6.608724443884731,3.88138369606814,27,16,26,38,12,12,8,12,73,84,70,62,15,4,18,26,0,0,4,0
858,0.8999999999999999,0.875,0.8974358974358975,0.8571428571428571,0.9411764705882353,3.466884540977896,5.578494132134137,6.1206937678360305,3.4804070496738415,24,39,28,34,9,9,9,9,73,58,69,63,15,30,19,25,3,3,3,3
859,0.8999999999999999,0.8235294117647058,0.8333333333333334,0.9411764705882353,1.0,3.5904642728660257,5.747207207492333,6.838781106876117,3.8770581622820335,17,48,17,34,8,8,8,5,79,48,79,59,9,40,9,29,4,4,4,7
860,0.8999999999999999,0.8571428571428571,0.8529411764705882,1.0,0.8823529411764706,3.4704925977002112,5.233602047963017,6.982306176028682,3.59955060661405,14,34,9,34,9,9,9,5,83,63,88,59,5,25,0,29,3,3,3,7
861,0.8999999999999999,0.6666666666666666,0.8947368421052632,1.0,0.9285714285714286,3.687596872110727,5.257254189968162,6.8655634656703635,3.9785061490136866,15,19,11,14,5,12,5,8,78,81,82,82,10,7,6,6,7,0,7,4
862,0.8999999999999999,0.9166666666666666,0.9090909090909091,1.0,0.8823529411764706,3.8075590317939407,6.0673036578078445,7.383074780007613,4.1202847036590144,12,22,5,17,9,9,5,9,85,75,88,80,3,13,0,8,3,3,7,3
863,0.8999999999999999,0.8846153846153846,0.972972972972973,0.9047619047619048,0.9130434782608695,3.672149744272614,5.525427277976325,6.322796721052495,3.8909009544683086,26,37,21,46,5,9,5,5,67,60,72,47,21,28,16,41,7,3,7,7
864,0.8999999999999999,0.9285714285714286,0.6666666666666666,0.9444444444444444,0.9285714285714286,3.8335039455539452,5.319476731662994,7.83105091835645,3.8993476216105525,14,12,18,14,9,9,12,9,83,85,82,83,5,3,6,5,3,3,0,3
865,0.8999999999999999,0.875,0.8,0.7391304347826086,0.896551724137931,3.7680968971722733,5.346171765004749,6.674140048602481,4.210650519295662,8,5,23,29,8,5,5,5,88,88,70,64,0,0,18,24,4,7,7,7
866,0.8999999999999999,0.7142857142857143,1.0,1.0,0.9130434782608695,3.698093963615246,5.4143488456460975,7.326173442593997,4.003586621791264,14,14,22,23,9,9,12,9,83,83,78,74,5,5,10,14,3,3,0,3
867,0.8999999999999999,0.8571428571428571,0.9090909090909091,1.0,0.9655172413793104,3.9631564350549247,6.0507206023403475,7.084892408690306,4.248090194814523,21,22,10,29,5,12,5,5,72,78,83,64,16,10,5,24,7,0,7,7
868,0.8999999999999999,0.8461538461538461,0.9629629629629629,1.0,0.967741935483871,3.6623268336258716,5.464710668334835,6.436592097108289,3.9297031517092944,13,27,15,31,9,5,5,9,84,66,78,66,4,22,10,22,3,7,7,3
869,0.8999999999999999,0.8,0.5,0.8,0.9166666666666666,3.8945206949324493,5.7995302314560355,6.830654654433059,4.452864082116259,5,4,5,12,5,0,5,8,88,84,88,84,0,4,0,4,7,12,7,4
870,0.8999999999999999,0.8235294117647058,0.7857142857142857,1.0,0.9310344827586207,3.772289004956272,5.195036216377775,6.791330464944732,4.0029286741228765,17,14,9,29,9,9,9,9,80,83,88,68,8,5,0,20,3,3,3,3
871,0.8999999999999999,0.8181818181818182,1.0,0.8461538461538461,0.8888888888888888,3.879158990848556,5.550561455540849,7.242069050573495,4.1796055551043105,22,21,13,27,9,9,9,9,75,76,84,70,13,12,4,18,3,3,3,3
872,0.8999999999999999,0.9,0.9285714285714286,1.0,0.88,3.681973108039906,5.850972263119042,6.8141624804409435,3.9367183724601387,10,28,5,25,5,9,5,5,83,69,88,68,5,19,0,20,7,3,7,7
873,0.8999999999999999,0.9,0.92,1.0,0.90625,3.7514624099393417,5.3311480402376255,6.954226382382079,3.9198214097509236,10,25,5,32,5,12,5,9,83,75,88,65,5,13,0,23,7,0,7,3
874,0.8999999999999999,0.7777777777777778,0.9230769230769231,0.7777777777777778,0.9444444444444444,3.484711253774263,4.950035461808095,5.858840731869878,3.746355076181549,9,13,9,36,9,9,9,12,88,84,88,64,0,4,0,24,3,3,3,0
875,0.8999999999999999,0.8461538461538461,0.918918918918919,0.7272727272727273,0.8888888888888888,3.818615355457818,6.146744812927213,6.56001731490148,4.197410514918163,13,37,11,27,9,9,3,9,84,60,80,70,4,28,8,18,3,3,9,3
876,0.8999999999999999,1.0,0.9583333333333334,0.9545454545454546,0.9583333333333334,3.5279184390150258,5.348062251699176,6.856562504285674,3.842169649599741,9,24,22,48,9,9,12,9,88,73,78,49,0,15,10,39,3,3,0,3
877,0.8999999999999999,0.7619047619047619,0.9032258064516129,1.0,0.918918918918919,3.5862587420513288,5.567451433159688,7.30385032281112,3.8631746034451684,21,31,19,37,9,9,9,8,76,66,78,59,12,22,10,29,3,3,3,4
878,0.8999999999999999,0.9411764705882353,0.9333333333333333,0.9411764705882353,0.9333333333333333,3.4570944064402864,5.190746940805402,5.624559253843255,3.6721236372592725,17,15,17,30,9,5,9,9,80,78,80,67,8,10,8,21,3,7,3,3
879,0.8999999999999999,0.5882352941176471,0.9705882352941176,0.7083333333333334,0.8571428571428571,3.923219292651086,6.236034820796443,7.444341282712294,4.113268777011339,17,34,24,21,9,9,12,8,80,63,76,75,8,25,12,13,3,3,0,4
880,0.8999999999999999,0.9166666666666666,0.85,0.9473684210526315,0.918918918918919,3.5560225204640616,5.176624554808238,7.0290915096236075,3.8561982357988467,12,20,19,37,9,5,5,9,85,73,74,60,3,15,14,28,3,7,7,3
881,0.8999999999999999,0.75,0.9090909090909091,1.0,0.9473684210526315,3.7971919621340358,6.10415791869209,7.00642804639071,4.114467283148843,12,44,12,19,9,9,12,9,85,53,88,78,3,35,0,10,3,3,0,3
882,0.8999999999999999,0.8421052631578947,0.9473684210526315,0.8695652173913043,0.9090909090909091,3.495488924610915,4.9563978767154735,6.384699465577111,3.636051743097313,19,19,23,22,9,5,9,12,78,74,74,78,10,14,14,10,3,7,3,0
883,0.8999999999999999,0.7894736842105263,0.7391304347826086,0.8333333333333334,0.8444444444444444,3.768500424764933,5.440264247602954,6.588570106580146,3.933323977204315,19,23,18,45,9,9,8,12,78,74,78,55,10,14,10,33,3,3,4,0
884,0.8999999999999999,0.6923076923076923,0.8888888888888888,0.7857142857142857,0.8461538461538461,3.6440811603141468,5.30903013772786,6.459200948406518,3.987708549222813,13,18,14,13,9,9,9,9,84,79,83,84,4,9,5,4,3,3,3,3
885,0.8999999999999999,0.8823529411764706,0.9130434782608695,0.9629629629629629,0.8928571428571429,3.7517270794416953,5.974603360126536,7.815011076170786,3.7671099868547957,17,23,27,28,9,9,9,9,80,74,70,69,8,14,18,19,3,3,3,3
886,0.8999999999999999,0.7692307692307693,1.0,0.7692307692307693,0.9166666666666666,3.629225107608062,4.869184973745267,6.222146633495412,3.86870216955039,13,5,13,24,5,5,5,5,80,88,80,69,8,0,8,19,7,7,7,7
887,0.8999999999999999,0.9333333333333333,0.7777777777777778,0.9333333333333333,0.8666666666666667,3.6923732022272335,5.3036021128978215,7.150854248280759,3.8830359882622925,15,36,30,45,5,12,12,12,78,64,70,55,10,24,18,33,7,0,0,0
888,0.8999999999999999,0.8888888888888888,0.8636363636363636,1.0,0.9090909090909091,3.612606282622181,5.143203473458488,7.098891898217892,3.7511245746931468,9,22,9,22,9,9,9,12,88,75,88,78,0,13,0,10,3,3,3,0
889,0.8999999999999999,0.8421052631578947,0.9666666666666667,0.8695652173913043,0.9722222222222222,3.7539156861478684,5.7755535707174825,6.837624493290539,3.9299749382767564,19,30,23,36,9,12,9,9,78,70,74,61,10,18,14,27,3,0,3,3
890,0.8999999999999999,0.84375,0.9259259259259259,0.7777777777777778,0.84375,3.8304131546023195,5.922509313342816,6.497896900239592,4.095764998649335,32,27,9,32,9,9,9,9,65,70,88,65,23,18,0,23,3,3,3,3
891,0.8999999999999999,0.7083333333333334,0.8695652173913043,0.875,0.868421052631579,3.5755599859931344,5.586423278484295,6.916021617621057,3.715796250354132,24,23,32,38,9,9,8,5,73,74,64,55,15,14,24,33,3,3,4,7
892,0.8999999999999999,0.7692307692307693,0.9347826086956522,0.7777777777777778,0.9423076923076923,3.4769191957138443,5.441465119311378,6.366117393022219,3.694503273922682,13,46,18,52,8,8,8,8,83,50,78,44,5,38,10,44,4,4,4,4
893,0.8999999999999999,0.7777777777777778,1.0,1.0,1.0,3.6150110279929857,5.222259485228474,6.485350632460896,4.031470189393113,9,8,10,13,9,5,5,9,88,85,83,84,0,3,5,4,3,7,7,3
894,0.8999999999999999,0.625,0.7647058823529411,1.0,1.0,3.836485064315212,5.384061259943215,7.706716000275666,4.13225279844899,16,17,22,17,9,5,9,9,81,76,75,80,7,12,13,8,3,7,3,3
895,0.8999999999999999,0.6666666666666666,0.8205128205128205,0.8787878787878788,0.7954545454545454,3.589734477824282,5.5428937242678105,6.545722184081833,3.7019199046671973,36,39,33,44,9,9,12,9,61,58,67,53,27,30,21,35,3,3,0,3
896,0.8999999999999999,0.8461538461538461,0.8928571428571429,0.90625,0.8846153846153846,3.637350683044413,5.463208520630613,6.944311598218526,3.7369814425591703,26,28,32,52,12,9,12,12,74,69,68,48,14,19,20,40,0,3,0,0
897,0.8999999999999999,0.8888888888888888,0.8648648648648649,0.9583333333333334,0.9285714285714286,3.4609911365002364,5.564970082004736,6.577786141620938,3.650896888012582,9,37,24,42,9,4,9,9,88,55,73,55,0,33,15,33,3,8,3,3
898,0.8999999999999999,0.7666666666666667,0.7428571428571429,0.7941176470588235,0.8611111111111112,3.8227175759298078,5.46161370115361,6.733839606169687,3.9400503189873533,30,35,34,36,7,9,7,9,65,62,61,61,23,26,27,27,5,3,5,3
899,0.8999999999999999,0.6923076923076923,0.9130434782608695,1.0,0.8837209302325582,3.72833881380533,5.2284322765055204,7.266052353253332,4.121415542049178,13,23,24,43,9,9,9,12,84,74,73,57,4,14,15,31,3,3,3,0
900,0.9999999999999999,0.75,0.8918918918918919,0.75,0.9,3.683180045331823,5.788049197635015,7.0095750957247365,3.8494761923737206,16,37,16,50,9,9,9,9,81,60,81,47,7,28,7,41,3,3,3,3
901,0.9999999999999999,0.7391304347826086,0.9130434782608695,0.8333333333333334,0.9722222222222222,3.6788882685484436,5.585076360266053,6.587602286431337,3.8475177809463386,23,23,24,36,9,9,9,12,74,74,73,64,14,14,15,24,3,3,3,0
902,0.9999999999999999,0.8421052631578947,0.9473684210526315,0.8947368421052632,1.0,3.6692610048430807,5.14867532592786,6.64006741914281,3.913762966312615,19,19,19,23,9,5,9,5,78,74,78,70,10,14,10,18,3,7,3,7
903,0.9999999999999999,0.8076923076923077,1.0,0.9117647058823529,0.9722222222222222,3.674968325715639,5.387585660523114,7.157534129530692,4.053595962731185,26,13,34,36,9,9,9,12,71,84,63,64,17,4,25,24,3,3,3,0
904,0.9999999999999999,0.9444444444444444,0.9444444444444444,0.8888888888888888,0.9130434782608695,3.84163459164776,5.748546979037269,6.860419596402719,3.9666774532425046,18,18,18,23,9,4,9,9,79,74,79,74,9,14,9,14,3,8,3,3
905,0.9999999999999999,0.7647058823529411,0.95,0.8571428571428571,0.9166666666666666,3.841053781144442,6.247633912466656,7.330705271034819,4.061584787689647,17,40,14,12,12,5,9,9,83,53,83,85,5,35,5,3,0,7,3,3
906,0.9999999999999999,0.7857142857142857,0.9166666666666666,0.9473684210526315,0.8571428571428571,3.7133209677428645,5.703365360583665,6.962818097652145,3.788055781088108,14,24,19,14,9,9,9,9,83,73,78,83,5,15,10,5,3,3,3,3
907,0.9999999999999999,0.8275862068965517,0.8947368421052632,0.7777777777777778,0.9444444444444444,3.683671207933526,4.923050430376267,6.66549808902511,3.778612400167736,29,19,18,18,5,5,9,9,64,74,79,79,24,14,9,9,7,7,3,3
908,0.9999999999999999,0.8518518518518519,0.9565217391304348,0.8888888888888888,0.9230769230769231,3.603063323702529,5.301878242147795,7.297997488380839,3.665290963371381,27,23,9,26,12,8,9,12,73,73,88,74,15,15,0,14,0,4,3,0
909,0.9999999999999999,0.8333333333333334,0.8076923076923077,0.7894736842105263,0.9230769230769231,3.8217757977107105,5.8252619792958305,6.560747897820408,4.154255297377401,12,26,19,13,9,4,9,9,85,66,78,84,3,22,10,4,3,8,3,3
910,0.9999999999999999,0.7857142857142857,0.95,1.0,0.967741935483871,3.664107121459068,5.402270931815574,6.335432922317231,4.049161098081587,14,20,12,31,9,5,12,9,83,73,88,66,5,15,0,22,3,7,0,3
911,0.9999999999999999,0.8888888888888888,0.9230769230769231,0.8888888888888888,0.8125,3.580509502022212,5.322098158985499,6.094466858725545,3.9015060060649205,9,13,9,32,9,9,9,12,88,84,88,68,0,4,0,20,3,3,3,0
912,0.9999999999999999,0.896551724137931,0.9545454545454546,0.8928571428571429,0.9487179487179487,3.735511958418476,5.820154795822129,7.265964683156592,3.902569811916145,29,44,28,39,12,12,9,12,71,56,69,61,17,32,19,27,0,0,3,0
913,0.9999999999999999,0.9,0.92,1.0,0.9333333333333333,3.8597108212305877,5.6945873487625125,8.050769798903165,4.09919885492225,30,25,36,45,5,9,8,12,63,72,60,55,25,16,28,33,7,3,4,0
914,0.9999999999999999,0.6923076923076923,0.9,0.8518518518518519,0.8,3.7607549143559664,5.608664777597993,7.462667879186918,4.072886111699621,13,40,27,30,5,9,5,5,80,57,66,63,8,31,22,25,7,3,7,7
915,0.9999999999999999,0.8333333333333334,0.896551724137931,0.9473684210526315,0.8888888888888888,3.7116578196439556,5.80567519901557,6.449279834439719,3.8693835416933644,12,29,19,36,5,9,5,5,81,68,74,57,7,20,14,31,7,3,7,7
916,0.9999999999999999,0.75,1.0,0.7777777777777778,0.9,3.875449196374626,5.410437262149976,7.048328338974396,4.126378608220745,12,12,9,30,9,9,9,9,85,85,88,67,3,3,0,21,3,3,3,3
917,0.9999999999999999,0.7142857142857143,0.9333333333333333,1.0,0.8125,3.6297999132675187,5.1778593316910095,6.935832459215629,3.85536553589775,14,15,9,16,5,0,0,0,79,73,79,72,9,15,9,16,7,12,12,12
918,0.9999999999999999,0.9333333333333333,0.8947368421052632,0.85,0.9444444444444444,3.685224996770765,5.969014768388865,7.1036257616270975,3.8409693338767537,15,38,20,18,5,5,5,5,78,55,73,75,10,33,15,13,7,7,7,7
919,0.9999999999999999,1.0,0.8620689655172413,0.9310344827586207,1.0,3.6639023036157132,5.580466060202949,7.297553860226644,3.7393811893914513,17,29,29,27,9,9,12,9,80,68,71,70,8,20,17,18,3,3,0,3
920,0.9999999999999999,0.8,1.0,0.9,0.8648648648648649,3.5713700263213406,5.179170546546939,6.000921714906123,3.6103671431847077,25,16,20,37,5,8,5,8,68,80,73,59,20,8,15,29,7,4,7,4
921,0.9999999999999999,0.75,0.8823529411764706,0.625,0.7857142857142857,3.745890976306471,5.7640938957206185,6.497900696232879,3.9775034603738386,8,17,8,28,8,8,8,8,88,79,88,68,0,9,0,20,4,4,4,4
922,0.9999999999999999,0.868421052631579,0.8695652173913043,0.9137931034482759,0.84,3.737719322471976,5.463041008536842,7.048240465468222,3.7109221875262604,38,23,58,50,12,12,12,12,62,77,42,50,26,11,46,38,0,0,0,0
923,0.9999999999999999,0.8125,0.8461538461538461,1.0,0.9428571428571428,3.809659455538265,5.633421504699067,6.968772477947023,4.100530529301859,16,26,10,35,12,12,5,12,84,74,83,65,4,14,5,23,0,0,7,0
924,0.9999999999999999,0.9,1.0,0.8235294117647058,0.9591836734693877,3.768477734132072,5.243412645472916,7.146502772460727,4.091097889144702,10,12,34,49,5,9,9,12,83,85,63,51,5,3,25,37,7,3,3,0
925,0.9999999999999999,0.9565217391304348,0.9545454545454546,0.96,0.9696969696969697,3.7375861403658917,5.611847196771133,6.884280348178563,3.8400570706070303,23,22,25,33,9,9,12,9,74,75,75,64,14,13,13,24,3,3,0,3
926,0.9999999999999999,0.9090909090909091,0.9166666666666666,0.8333333333333334,0.9333333333333333,3.8235905725699912,5.177533222262251,7.152191224930494,4.1094966782373685,11,12,12,30,8,8,8,8,85,84,84,66,3,4,4,22,4,4,4,4
927,0.9999999999999999,0.84375,0.9302325581395349,0.9130434782608695,0.9038461538461539,3.6199614977010883,5.428090499148094,6.930264233395153,3.725859241912484,32,43,23,52,5,5,5,5,61,50,70,41,27,38,18,47,7,7,7,7
928,0.9999999999999999,1.0,1.0,1.0,0.9393939393939394,3.5864449596421264,5.92161850028129,6.180166046374149,4.0213589288095575,9,29,15,33,9,5,12,9,88,64,85,64,0,24,3,24,3,7,0,3
929,0.9999999999999999,0.8888888888888888,0.8863636363636364,0.8888888888888888,0.8823529411764706,3.6102781012400644,6.155915801757703,6.201954146260342,3.8659124843441304,18,44,9,17,9,5,9,9,79,49,88,80,9,39,0,8,3,7,3,3
930,0.9999999999999999,0.9473684210526315,0.9166666666666666,0.9310344827586207,0.896551724137931,3.6565533260371192,5.470412112003096,7.403405942779621,3.797335302355448,19,24,29,29,9,9,9,9,78,73,68,68,10,15,20,20,3,3,3,3
931,0.9999999999999999,0.6666666666666666,0.875,0.8695652173913043,0.8064516129032258,3.7036561313303014,5.531727133874426,7.0040569239652335,3.913059235506228,27,24,23,31,12,9,8,12,73,73,73,69,15,15,15,19,0,3,4,0
932,0.9999999999999999,0.8108108108108109,0.9130434782608695,0.9428571428571428,0.8732394366197183,3.8343213772388673,5.475805379140096,6.9689101395178135,3.893033997942126,37,46,35,71,9,9,9,9,60,51,62,26,28,37,26,62,3,3,3,3
933,0.9999999999999999,0.75,1.0,0.9166666666666666,0.9545454545454546,3.549173469285506,5.433452375213387,6.1314746299591825,3.8611413595799857,8,18,12,22,8,8,12,5,88,78,88,71,0,10,0,17,4,4,0,7
934,0.9999999999999999,0.75,0.8571428571428571,0.875,0.875,3.6123149366036365,5.537434517365847,6.9961856008947025,3.7782469673498427,24,21,24,24,9,5,9,9,73,72,73,73,15,16,15,15,3,7,3,3
935,0.9999999999999999,0.8421052631578947,0.8928571428571429,0.7368421052631579,0.8636363636363636,3.7497271022170837,5.624883462937656,6.6044097780196225,3.9062923806444805,19,28,19,22,9,9,9,12,78,69,78,78,10,19,10,10,3,3,3,0
936,0.9999999999999999,0.9166666666666666,0.9375,1.0,0.9642857142857143,3.75806309530155,5.916447851683589,6.664432694342953,3.7773934475839956,12,48,8,28,12,8,8,8,88,48,88,68,0,40,0,20,0,4,4,4
937,0.9999999999999999,0.8260869565217391,0.8958333333333334,0.8947368421052632,1.0,3.754071790504033,5.983516422163649,6.892468332748564,3.983562243910528,23,48,19,33,9,12,9,9,74,52,78,64,14,36,10,24,3,0,3,3
938,0.9999999999999999,0.6428571428571429,0.7647058823529411,0.8387096774193549,0.8571428571428571,3.620913476044845,5.054481081383779,7.031738790436538,3.802057105063073,14,17,31,28,9,9,9,9,83,80,66,69,5,8,22,19,3,3,3,3
939,0.9999999999999999,1.0,0.9230769230769231,0.8421052631578947,0.9411764705882353,3.9608703060110733,6.206459558022031,6.822998572917766,4.210777192553377,9,39,19,34,9,9,9,9,88,58,78,63,0,30,10,25,3,3,3,3
940,0.9999999999999999,0.9375,0.8888888888888888,0.9375,0.9259259259259259,3.7372396018357934,5.354521961018954,6.517367665591541,3.9781409599843705,16,18,16,27,9,5,9,9,81,75,81,70,7,13,7,18,3,7,3,3
941,0.9999999999999999,0.9166666666666666,0.9130434782608695,0.9333333333333333,0.875,3.676679547320212,5.897559219303838,6.614314811101265,3.8901248004885725,12,46,15,32,12,9,5,9,88,51,78,65,0,37,10,23,0,3,7,3
942,0.9999999999999999,0.9166666666666666,0.8333333333333334,0.8928571428571429,1.0,3.788917873110312,5.559908802166123,6.525944540003058,4.033257920506713,24,30,28,13,9,12,4,4,73,70,64,79,15,18,24,9,3,0,8,8
943,0.9999999999999999,0.6428571428571429,0.9142857142857143,0.9,0.9302325581395349,3.742563701329334,5.821095711413493,7.090685932770819,3.957600120750358,14,35,20,43,9,5,5,9,83,58,73,54,5,30,15,34,3,7,7,3
944,0.9999999999999999,0.75,0.8333333333333334,0.8148148148148148,0.8823529411764706,3.767448871101839,5.8077541810787165,7.023258539638619,4.039313784130713,24,36,27,51,9,9,9,9,73,61,70,46,15,27,18,42,3,3,3,3
945,0.9999999999999999,0.8695652173913043,0.8666666666666667,0.8421052631578947,0.8823529411764706,4.0095544340367955,5.932915073764655,7.054509706561668,4.246397222771705,23,30,19,51,9,5,5,12,74,63,74,49,14,25,14,39,3,7,7,0
946,0.9999999999999999,0.8421052631578947,0.9130434782608695,0.9473684210526315,0.8571428571428571,3.7943335239669858,5.585333601893073,7.210267724555142,4.002182977711516,19,23,19,28,9,9,9,9,78,74,78,69,10,14,10,19,3,3,3,3
947,0.9999999999999999,0.8888888888888888,1.0,0.6666666666666666,0.8888888888888888,3.716807916418245,5.523010285944115,6.3806555654164745,3.948352636450018,9,24,9,63,9,9,9,9,88,73,88,34,0,15,0,54,3,3,3,3
948,0.9999999999999999,1.0,1.0,0.8,1.0,3.6519541898625887,5.071355886333733,6.227529673568563,4.011398763757519,5,10,5,18,5,5,5,5,88,83,88,75,0,5,0,13,7,7,7,7
949,0.9999999999999999,0.8947368421052632,0.9285714285714286,0.8,0.875,3.787512438377314,5.409807412236539,6.1138369665168275,4.008204126272839,19,28,5,24,9,9,5,9,78,69,88,73,10,19,0,15,3,3,7,3
950,0.9999999999999999,0.9166666666666666,0.7857142857142857,0.9655172413793104,0.9142857142857143,3.780319560111004,5.350970971269386,8.11404658153205,4.051216891124536,24,14,29,35,9,9,9,12,73,83,68,65,15,5,20,23,3,3,3,0
951,0.9999999999999999,0.8,0.8823529411764706,0.8333333333333334,0.8043478260869565,3.8378186490564894,5.4185016130772325,7.215730246917135,3.884820159322228,25,17,24,46,12,9,12,12,75,80,76,54,13,8,12,34,0,3,0,0
952,0.9999999999999999,0.7931034482758621,0.8448275862068966,0.9318181818181818,0.9038461538461539,3.753028694082044,5.96320086413392,7.210949391417525,3.8408021187501067,29,58,44,52,9,12,9,9,68,42,53,45,20,46,35,43,3,0,3,3
953,0.9999999999999999,0.7142857142857143,0.9166666666666666,0.9285714285714286,0.8333333333333334,3.6234703665918664,5.2536071327870815,6.727365304452708,3.7656712541263837,14,24,14,18,9,9,9,9,83,73,83,79,5,15,5,9,3,3,3,3
954,0.9999999999999999,0.8461538461538461,0.875,0.9,0.8518518518518519,3.640917934640396,5.393883202817894,7.232909247777544,3.934788042377502,13,16,10,27,9,9,5,12,84,81,83,73,4,7,5,15,3,3,7,0
955,0.9999999999999999,0.7333333333333333,0.7894736842105263,0.8,0.8648648648648649,3.622313728283635,5.2882922573271784,7.133521088680816,3.870167140309874,15,19,10,37,5,5,0,12,78,74,78,63,10,14,10,25,7,7,12,0
956,0.9999999999999999,1.0,0.9285714285714286,0.7777777777777778,1.0,3.8973189421360033,6.0659768816315465,6.977051016617014,4.384023387675712,9,28,9,30,9,8,5,9,88,68,84,67,0,20,4,21,3,4,7,3
957,0.9999999999999999,0.7777777777777778,0.9375,0.8666666666666667,0.8157894736842105,3.571119344357557,4.912441161346942,6.620504072404887,3.877257059672465,27,16,30,38,12,12,12,12,73,84,70,62,15,4,18,26,0,0,0,0
958,0.9999999999999999,0.875,0.8974358974358975,0.8571428571428571,0.9411764705882353,3.4667262898356213,5.578219691224691,6.11997939018227,3.479905501818179,24,39,28,34,9,9,9,9,73,58,69,63,15,30,19,25,3,3,3,3
959,0.9999999999999999,0.8235294117647058,0.8333333333333334,0.9411764705882353,1.0,3.5923614161008413,5.749108272577883,6.8458432852671285,3.982636677541678,17,48,17,34,8,8,8,5,79,48,79,59,9,40,9,29,4,4,4,7
960,0.9999999999999999,0.8571428571428571,0.8529411764705882,1.0,0.8947368421052632,3.4702476822138264,5.233221675394248,6.980967043134712,3.616112458815325,14,34,9,38,9,9,9,9,83,63,88,59,5,25,0,29,3,3,3,3
961,0.9999999999999999,0.7333333333333333,0.8947368421052632,1.0,0.9285714285714286,3.6880024656466324,5.257254189968162,6.867592378422719,4.0977034790322895,15,19,11,14,5,12,5,8,78,81,82,82,10,7,6,6,7,0,7,4
962,0.9999999999999999,0.9166666666666666,0.9090909090909091,1.0,0.8823529411764706,3.8073519280976087,6.066584443569576,7.393790714198593,3.9417474895225153,12,22,5,17,9,9,5,9,85,75,88,80,3,13,0,8,3,3,7,3
963,0.9999999999999999,0.8846153846153846,0.972972972972973,0.9047619047619048,0.9130434782608695,3.672773586124457,5.5252401692876045,6.329659988590193,3.890186098319815,26,37,21,46,5,9,5,5,67,60,72,47,21,28,16,41,7,3,7,7
964,0.9999999999999999,0.9411764705882353,0.6666666666666666,0.9444444444444444,0.9285714285714286,3.812946463870228,5.320515526949326,7.83105091835645,3.8958693086260263,17,12,18,14,12,9,12,9,83,85,82,83,5,3,6,5,0,3,0,3
965,0.9999999999999999,0.875,0.8,0.7391304347826086,0.8787878787878788,3.770052197205776,5.350147512770502,6.677330003530346,4.113670672882207,8,5,23,33,8,5,5,9,88,88,70,64,0,0,18,24,4,7,7,3
966,0.9999999999999999,0.7142857142857143,1.0,1.0,0.9130434782608695,3.698734677958122,5.415193773849565,7.326173442593995,3.9925309577190875,14,14,22,23,9,9,12,9,83,83,78,74,5,5,10,14,3,3,0,3
967,0.9999999999999999,0.8571428571428571,0.9090909090909091,1.0,0.9655172413793104,3.9656733168920844,6.0507206023403475,7.088002971702278,4.297572601542534,21,22,10,29,5,12,5,5,72,78,83,64,16,10,5,24,7,0,7,7
968,0.9999999999999999,0.8461538461538461,0.9629629629629629,1.0,0.967741935483871,3.6627052290840387,5.471766015162853,6.443182985681711,3.926755485480101,13,27,15,31,9,5,5,9,84,66,78,66,4,22,10,22,3,7,7,3
969,0.9999999999999999,0.8,0.7142857142857143,0.8,0.9166666666666666,3.895904464295806,5.7596670557727565,6.8339560187502855,4.442360701764091,5,7,5,12,5,3,5,8,88,84,88,84,0,4,0,4,7,9,7,4
970,0.9999999999999999,0.8235294117647058,0.7857142857142857,1.0,0.9310344827586207,3.771959916400782,5.194200788182565,6.79059185821788,3.9973438925584888,17,14,9,29,9,9,9,9,80,83,88,68,8,5,0,20,3,3,3,3
971,0.9999999999999999,0.8181818181818182,1.0,0.8461538461538461,0.8888888888888888,3.87907800522408,5.55004803335978,7.24134954088024,4.00292487700163,22,21,13,27,9,9,9,9,75,76,84,70,13,12,4,18,3,3,3,3
972,0.9999999999999999,0.9,0.9285714285714286,1.0,0.88,3.682996460082369,5.849718422445549,6.8150087974921405,3.9288245923958285,10,28,5,25,5,9,5,5,83,69,88,68,5,19,0,20,7,3,7,7
973,0.9999999999999999,0.9,0.92,1.0,0.9375,3.7528676987454945,5.3311480402376255,6.9565725319658895,3.9497784319010005,10,25,5,32,5,12,5,9,83,75,88,65,5,13,0,23,7,0,7,3
974,0.9999999999999999,0.7777777777777778,0.9230769230769231,0.7777777777777778,0.9444444444444444,3.485001959633569,4.9502547217635975,5.859646970905385,3.742283240717639,9,13,9,36,9,9,9,12,88,84,88,64,0,4,0,24,3,3,3,0
975,0.9999999999999999,0.8461538461538461,0.918918918918919,0.7272727272727273,0.8666666666666667,3.8188583824735383,6.147334139709557,6.58640160725256,4.187424054715228,13,37,11,30,9,9,3,12,84,60,80,70,4,28,8,18,3,3,9,0
976,0.9999999999999999,1.0,0.9583333333333334,0.9545454545454546,0.9583333333333334,3.528026355850379,5.348706661192554,6.856562504285674,3.8404254492724923,9,24,22,48,9,9,12,9,88,73,78,49,0,15,10,39,3,3,0,3
977,0.9999999999999999,0.7619047619047619,0.9032258064516129,1.0,0.8536585365853658,3.586440992809119,5.567896658758405,7.305016209975083,4.070450767551217,21,31,19,41,9,9,9,12,76,66,78,59,12,22,10,29,3,3,3,0
978,0.9999999999999999,0.9411764705882353,0.9333333333333333,0.9411764705882353,0.9666666666666667,3.4573766749434327,5.196073880398436,5.6261330597027435,3.6904570181585146,17,15,17,30,9,5,9,9,80,78,80,67,8,10,8,21,3,7,3,3
979,0.9999999999999999,0.5882352941176471,0.9705882352941176,0.7083333333333334,0.88,3.9237898649540757,6.236991862805063,7.444341282712294,4.091856029228887,17,34,24,25,9,9,12,12,80,63,76,75,8,25,12,13,3,3,0,0
980,0.9999999999999999,0.9166666666666666,0.85,0.9473684210526315,0.972972972972973,3.556413502744187,5.185080380155847,7.0419595815354885,3.8300763835924565,12,20,19,37,9,5,5,9,85,73,74,60,3,15,14,28,3,7,7,3
981,0.9999999999999999,0.75,0.9090909090909091,1.0,0.9473684210526315,3.7971290881368875,6.10353684971685,7.00642804639071,4.111454799205119,12,44,12,19,9,9,12,9,85,53,88,78,3,35,0,10,3,3,0,3
982,0.9999999999999999,0.8421052631578947,0.9166666666666666,0.8695652173913043,0.9090909090909091,3.4952213642634553,4.989051112792963,6.385284531993294,3.636691784308793,19,24,23,22,9,5,9,12,78,69,74,78,10,19,14,10,3,7,3,0
983,0.9999999999999999,0.7894736842105263,0.7391304347826086,0.8666666666666667,0.8444444444444444,3.7679105952931495,5.438263724989914,6.630694347911202,3.931902047763244,19,23,15,45,9,9,5,12,78,74,78,55,10,14,10,33,3,3,7,0
984,0.9999999999999999,0.6923076923076923,0.8888888888888888,0.7857142857142857,0.8461538461538461,3.6440235570282846,5.309115568008431,6.458481944250512,3.9669176852158756,13,18,14,13,9,9,9,9,84,79,83,84,4,9,5,4,3,3,3,3
985,0.9999999999999999,0.8823529411764706,0.9130434782608695,0.9629629629629629,0.8928571428571429,3.752121545360591,5.975262687712324,7.816637182978837,3.7597559050654468,17,23,27,28,9,9,9,9,80,74,70,69,8,14,18,19,3,3,3,3
986,0.9999999999999999,0.7692307692307693,1.0,0.8888888888888888,0.9166666666666666,3.630728395808316,4.903727269145801,6.140694223078706,3.868144905312708,13,9,9,24,5,9,5,5,80,88,84,69,8,0,4,19,7,3,7,7
987,0.9999999999999999,0.9473684210526315,0.7777777777777778,0.9333333333333333,0.8888888888888888,3.6901182118392377,5.3036021128978215,7.1508542482807576,3.844976779684636,19,36,30,45,9,12,12,12,78,64,70,55,10,24,18,33,3,0,0,0
988,0.9999999999999999,0.8888888888888888,0.8636363636363636,1.0,0.9090909090909091,3.6128992758202347,5.143385583445973,7.099042934666837,3.7999040342593062,9,22,9,22,9,9,9,12,88,75,88,78,0,13,0,10,3,3,3,0
989,0.9999999999999999,0.8421052631578947,0.9666666666666667,0.8695652173913043,0.9166666666666666,3.7547882587814994,5.775553570717482,6.8390741888538225,3.9086003277107744,19,30,23,36,9,12,9,9,78,70,74,61,10,18,14,27,3,0,3,3
990,0.9999999999999999,0.84375,0.9259259259259259,0.7777777777777778,0.84375,3.8305108207211904,5.922442756035639,6.498582492246292,4.091782043256295,32,27,9,32,9,9,9,9,65,70,88,65,23,18,0,23,3,3,3,3
991,0.9999999999999999,0.7586206896551724,0.8695652173913043,0.875,0.8947368421052632,3.605546386921608,5.588047205784159,6.9284504563765115,3.77735305349258,29,23,32,38,9,9,8,5,68,74,64,55,20,14,24,33,3,3,4,7
992,0.9999999999999999,0.7692307692307693,0.9285714285714286,0.7777777777777778,0.9423076923076923,3.4781958535702557,5.330123196637696,6.375011596752103,3.6627351634644585,13,42,18,52,8,8,8,8,83,54,78,44,5,34,10,44,4,4,4,4
993,0.9999999999999999,0.7777777777777778,1.0,1.0,1.0,3.615081445935869,5.226228884312828,6.490386386838891,4.021627994633243,9,8,10,13,9,5,5,9,88,85,83,84,0,3,5,4,3,7,7,3
994,0.9999999999999999,0.625,0.7647058823529411,1.0,0.9411764705882353,3.8363988384509455,5.391589814981187,7.7080861144222785,4.154482173205147,16,17,22,17,9,5,9,9,81,76,75,80,7,12,13,8,3,7,3,3
995,0.9999999999999999,0.6666666666666666,0.8205128205128205,0.8787878787878788,0.7954545454545454,3.5902317927395018,5.544077283296325,6.545722184081833,3.7002708326574787,36,39,33,44,9,9,12,9,61,58,67,53,27,30,21,35,3,3,0,3
996,0.9999999999999999,0.8461538461538461,0.8928571428571429,0.90625,0.9038461538461539,3.637350683044413,5.465233427475902,6.944311598218526,3.7428930735457766,26,28,32,52,12,9,12,12,74,69,68,48,14,19,20,40,0,3,0,0
997,0.9999999999999999,0.8888888888888888,0.8648648648648649,0.9583333333333334,0.9285714285714286,3.460808739581501,5.582245540754259,6.575437371160237,3.649865455034763,9,37,24,42,9,4,9,9,88,55,73,55,0,33,15,33,3,8,3,3
998,0.9999999999999999,0.7666666666666667,0.7631578947368421,0.7941176470588235,0.8611111111111112,3.8278641124012713,5.4461333968679035,6.74282192783331,3.932878036375448,30,38,34,36,7,12,7,9,65,62,61,61,23,26,27,27,5,0,5,3
999,0.9999999999999999,0.6923076923076923,0.9130434782608695,1.0,0.8837209302325582,3.7285556619598945,5.228146109778198,7.26821376955953,4.175862149297625,13,23,24,43,9,9,9,12,84,74,73,57,4,14,15,31,3,3,3,0
1000,1.0999999999999999,0.75,0.8918918918918919,0.75,0.9,3.6833362936853202,5.789324005501238,7.009089666420822,3.8486342229727755,16,37,16,50,9,9,9,9,81,60,81,47,7,28,7,41,3,3,3,3
1001,1.0999999999999999,0.7391304347826086,0.9130434782608695,0.8333333333333334,0.9722222222222222,3.6792610890852346,5.585056614649074,6.586761715382789,3.8488242778004667,23,23,24,36,9,9,9,12,74,74,73,64,14,14,15,24,3,3,3,0
1002,1.0999999999999999,0.8421052631578947,0.9473684210526315,0.8947368421052632,1.0,3.669592821027561,5.154509322440444,6.640665386392449,3.9204853148896763,19,19,19,23,9,5,9,5,78,74,78,70,10,14,10,18,3,7,3,7
1003,1.0999999999999999,0.8076923076923077,1.0,0.9117647058823529,0.9722222222222222,3.67550985037078,5.389006175691643,7.157789220732475,4.0503361572094185,26,13,34,36,9,9,9,12,71,84,63,64,17,4,25,24,3,3,3,0
1004,1.0999999999999999,0.9444444444444444,0.9444444444444444,0.8888888888888888,0.9130434782608695,3.841435839129675,5.763604020290032,6.86081271236428,3.9567856432824016,18,18,18,23,9,4,9,9,79,74,79,74,9,14,9,14,3,8,3,3
1005,1.0999999999999999,0.7647058823529411,0.95,0.8571428571428571,0.9166666666666666,3.841053781144441,6.260029345852553,7.330402228979517,4.0837731292601545,17,40,14,12,12,5,9,9,83,53,83,85,5,35,5,3,0,7,3,3
1006,1.0999999999999999,0.7857142857142857,0.9166666666666666,0.9473684210526315,0.8571428571428571,3.7136763654808873,5.704187483610322,6.962221644907415,3.7807024849547846,14,24,19,14,9,9,9,9,83,73,78,83,5,15,10,5,3,3,3,3
1007,1.0999999999999999,0.8484848484848485,0.8947368421052632,0.7777777777777778,0.9444444444444444,3.6715763782889788,4.928779100410942,6.666588624528656,3.7745983427228413,33,19,18,18,9,5,9,9,64,74,79,79,24,14,9,9,3,7,3,3
1008,1.0999999999999999,0.8518518518518519,0.8888888888888888,0.8888888888888888,0.8846153846153846,3.603063323702529,5.169372327402001,7.299338042478845,3.6625712719042345,27,27,9,26,12,12,9,12,73,73,88,74,15,15,0,14,0,0,3,0
1009,1.0999999999999999,0.8333333333333334,0.7741935483870968,0.7894736842105263,0.9230769230769231,3.8220979524350565,5.572289657871392,6.561997775709631,3.9684580950388275,12,31,19,13,9,9,9,9,85,66,78,84,3,22,10,4,3,3,3,3
1010,1.0999999999999999,0.7857142857142857,0.95,1.0,0.967741935483871,3.6644585183924834,5.409389501693958,6.3354329223172305,4.04792706157197,14,20,12,31,9,5,12,9,83,73,88,66,5,15,0,22,3,7,0,3
1011,1.0999999999999999,0.8888888888888888,0.9230769230769231,0.8888888888888888,0.84375,3.5808926451439294,5.32305351917645,6.0961998229117995,3.8405088422739677,9,13,9,32,9,9,9,12,88,84,88,68,0,4,0,20,3,3,3,0
1012,1.0999999999999999,0.896551724137931,0.9545454545454546,0.8928571428571429,0.9487179487179487,3.735511958418476,5.820154795822129,7.268810113413375,3.899367081912202,29,44,28,39,12,12,9,12,71,56,69,61,17,32,19,27,0,0,3,0
1013,1.0999999999999999,0.9,0.92,1.0,0.9333333333333333,3.862893439301559,5.6959389523355615,8.058487156025853,4.093808528105208,30,25,36,45,5,9,8,12,63,72,60,55,25,16,28,33,7,3,4,0
1014,1.0999999999999999,0.6923076923076923,0.9,0.8518518518518519,0.8,3.7627322275543023,5.609914146441234,7.46579220600123,4.07124233802611,13,40,27,30,5,9,5,5,80,57,66,63,8,31,22,25,7,3,7,7
1015,1.0999999999999999,0.8333333333333334,0.896551724137931,0.9473684210526315,0.8888888888888888,3.7141380182106594,5.80595563176613,6.45811970256407,3.85709278480057,12,29,19,36,5,9,5,5,81,68,74,57,7,20,14,31,7,3,7,7
1016,1.0999999999999999,0.75,1.0,0.7777777777777778,0.9333333333333333,3.875640270939813,5.410599412012508,7.049546063696244,4.171128328332086,12,12,9,30,9,9,9,9,85,85,88,67,3,3,0,21,3,3,3,3
1017,1.0999999999999999,0.7142857142857143,0.9333333333333333,1.0,0.7619047619047619,3.6309040635959744,5.192864444943016,6.955067895407083,4.055807914074563,14,15,9,21,5,0,0,5,79,73,79,72,9,15,9,16,7,12,12,7
1018,1.0999999999999999,0.9333333333333333,0.8947368421052632,0.85,0.9444444444444444,3.6880229265448894,5.973451168558834,7.113016885581736,3.8388667961651484,15,38,20,18,5,5,5,5,78,55,73,75,10,33,15,13,7,7,7,7
1019,1.0999999999999999,0.95,0.8620689655172413,0.9310344827586207,0.9629629629629629,3.6513985325193516,5.582048574548259,7.297553860226645,3.864690545695593,20,29,29,27,12,9,12,9,80,68,71,70,8,20,17,18,0,3,0,3
1020,1.0999999999999999,0.8,1.0,0.9,0.8918918918918919,3.5731840982573084,5.1837234590698245,6.006542990946914,3.500679200820778,25,16,20,37,5,8,5,8,68,80,73,59,20,8,15,29,7,4,7,4
1021,1.0999999999999999,0.75,0.8823529411764706,0.625,0.8214285714285714,3.7480416105336465,5.765846758239574,6.502025633460104,3.979232191211533,8,17,8,28,8,8,8,8,88,79,88,68,0,9,0,20,4,4,4,4
1022,1.0999999999999999,0.868421052631579,0.8695652173913043,0.9137931034482759,0.84,3.737719322471977,5.463041008536842,7.048240465468222,3.892695862602253,38,23,58,50,12,12,12,12,62,77,42,50,26,11,46,38,0,0,0,0
1023,1.0999999999999999,0.8125,0.8461538461538461,1.0,0.9714285714285714,3.809659455538265,5.633421504699067,6.977391990632043,4.270508658547324,16,26,10,35,12,12,5,12,84,74,83,65,4,14,5,23,0,0,7,0
1024,1.0999999999999999,0.9,1.0,0.8235294117647058,0.9387755102040817,3.7716387258829633,5.24427916928904,7.146837845594482,3.9772378304400604,10,12,34,49,5,9,9,12,83,85,63,51,5,3,25,37,7,3,3,0
1025,1.0999999999999999,0.9230769230769231,0.9545454545454546,0.96,1.0,3.698304179285093,5.613223885487338,6.8842803481785655,3.826275622171205,13,22,25,33,9,9,12,9,84,75,75,64,4,13,13,24,3,3,0,3
1026,1.0999999999999999,0.9090909090909091,0.9166666666666666,0.8333333333333334,0.9333333333333333,3.824851182820345,5.1813782685094,7.158238769314778,4.1062914744415,11,12,12,30,8,8,8,8,85,84,84,66,3,4,4,22,4,4,4,4
1027,1.0999999999999999,0.84375,0.9302325581395349,0.9130434782608695,0.9230769230769231,3.621764600351451,5.4309724603266005,6.933583431337292,3.6900657375770924,32,43,23,52,5,5,5,5,61,50,70,41,27,38,18,47,7,7,7,7
1028,1.0999999999999999,1.0,1.0,1.0,0.9696969696969697,3.586656579129084,5.930227501978239,6.180166046374148,4.207319891790241,9,29,15,33,9,5,12,9,88,64,85,64,0,24,3,24,3,7,0,3
1029,1.0999999999999999,0.8888888888888888,0.8863636363636364,0.8888888888888888,0.8823529411764706,3.610974133449043,6.160531503237093,6.203467878814729,3.8539543151741604,18,44,9,17,9,5,9,9,79,49,88,80,9,39,0,8,3,7,3,3
1030,1.0999999999999999,0.9473684210526315,0.9166666666666666,0.9310344827586207,0.896551724137931,3.6566661532150757,5.469621911392008,7.404543852815459,3.7934082236361,19,24,29,29,9,9,9,9,78,73,68,68,10,15,20,20,3,3,3,3
1031,1.0999999999999999,0.6666666666666666,0.875,0.8695652173913043,0.8064516129032258,3.7036561313303005,5.53297787022233,7.005938416133409,3.9160793331180743,27,24,23,31,12,9,8,12,73,73,73,69,15,15,15,19,0,3,4,0
1032,1.0999999999999999,0.8108108108108109,0.9130434782608695,0.9428571428571428,0.8732394366197183,3.8344013862767214,5.475625169529525,6.968804213618944,3.8919788436612275,37,46,35,71,9,9,9,9,60,51,62,26,28,37,26,62,3,3,3,3
1033,1.0999999999999999,0.75,1.0,0.9166666666666666,0.8636363636363636,3.5508374849145303,5.437384770970618,6.1314746299591825,4.018393044630456,8,18,12,22,8,8,12,5,88,78,88,71,0,10,0,17,4,4,0,7
1034,1.0999999999999999,0.75,0.8571428571428571,0.875,0.75,3.6123226678386833,5.543627100972884,6.996378088459942,3.7514783366607305,24,21,24,24,9,5,9,9,73,72,73,73,15,16,15,15,3,7,3,3
1035,1.0999999999999999,0.8421052631578947,0.8928571428571429,0.7368421052631579,0.8636363636363636,3.750021257600842,5.625633080118783,6.606408226059548,4.016163917475715,19,28,19,22,9,9,9,12,78,69,78,78,10,19,10,10,3,3,3,0
1036,1.0999999999999999,0.9166666666666666,0.9375,1.0,0.9642857142857143,3.758063095301551,5.919787078928761,6.773678508060386,3.7764880717126883,12,48,12,28,12,8,12,8,88,48,88,68,0,40,0,20,0,4,0,4
1037,1.0999999999999999,0.8260869565217391,0.8958333333333334,0.8947368421052632,1.0,3.7545361724882396,5.983516422163649,6.893870960534212,3.9823356130478063,23,48,19,33,9,12,9,9,74,52,78,64,14,36,10,24,3,0,3,3
1038,1.0999999999999999,0.6428571428571429,0.7647058823529411,0.8387096774193549,0.8928571428571429,3.6210880457574284,5.055020428773204,7.030547857559361,3.778328887825812,14,17,31,28,9,9,9,9,83,80,66,69,5,8,22,19,3,3,3,3
1039,1.0999999999999999,1.0,0.9230769230769231,0.8421052631578947,0.9411764705882353,3.961236925778577,6.20693316354736,6.8234125458393775,4.2078426134326214,9,39,19,34,9,9,9,9,88,58,78,63,0,30,10,25,3,3,3,3
1040,1.0999999999999999,0.9375,0.8888888888888888,0.9375,0.9259259259259259,3.7375629426090344,5.360164824375499,6.518531576169197,3.973903008144262,16,18,16,27,9,5,9,9,81,75,81,70,7,13,7,18,3,7,3,3
1041,1.0999999999999999,0.9166666666666666,0.9130434782608695,0.9333333333333333,0.875,3.676679547320212,5.899754512550407,6.629565525545417,3.887824043724901,12,46,15,32,12,9,5,9,88,51,78,65,0,37,10,23,0,3,7,3
1042,1.0999999999999999,0.9166666666666666,0.8333333333333334,0.8928571428571429,0.8823529411764706,3.789539775287702,5.559908802166122,6.542936750717111,4.642206489836288,24,30,28,17,9,12,4,4,73,70,64,75,15,18,24,13,3,0,8,8
1043,1.0999999999999999,0.6428571428571429,0.9142857142857143,0.9,0.9302325581395349,3.7423011618887396,5.822891324247383,7.089520721421136,3.9555041824491317,14,35,20,43,9,5,5,9,83,58,73,54,5,30,15,34,3,7,7,3
1044,1.0999999999999999,0.75,0.8333333333333334,0.8148148148148148,0.8431372549019608,3.7679127833674393,5.809180640046429,7.025499376934954,3.954641137706851,24,36,27,51,9,9,9,9,73,61,70,46,15,27,18,42,3,3,3,3
1045,1.0999999999999999,0.8695652173913043,0.8666666666666667,0.8421052631578947,0.8823529411764706,4.010046114937689,5.939694850379497,7.061392339223796,4.240551182765193,23,30,19,51,9,5,5,12,74,63,74,49,14,25,14,39,3,7,7,0
1046,1.0999999999999999,0.8421052631578947,0.9130434782608695,0.9473684210526315,0.8928571428571429,3.7943748871432503,5.585796385591183,7.209360451098995,4.046466631212157,19,23,19,28,9,9,9,9,78,74,78,69,10,14,10,19,3,3,3,3
1047,1.0999999999999999,0.8888888888888888,1.0,0.6666666666666666,0.8888888888888888,3.7172504371538246,5.524021805095813,6.382468500088813,4.095467091999473,9,24,9,63,9,9,9,9,88,73,88,34,0,15,0,54,3,3,3,3
1048,1.0999999999999999,1.0,1.0,0.8,1.0,3.6532292064227896,5.073458177467305,6.231172180054105,4.009279748316815,5,10,5,18,5,5,5,5,88,83,88,75,0,5,0,13,7,7,7,7
1049,1.0999999999999999,0.8947368421052632,0.9285714285714286,0.8888888888888888,0.875,3.7874324285307233,5.410125535745438,6.231262953285296,4.004438769302323,19,28,9,24,9,9,9,9,78,69,88,73,10,19,0,15,3,3,3,3
1050,1.0999999999999999,0.9166666666666666,0.7857142857142857,0.9655172413793104,0.9142857142857143,3.7807987851133302,5.35146818871278,8.114247411697148,4.048840484962478,24,14,29,35,9,9,9,12,73,83,68,65,15,5,20,23,3,3,3,0
1051,1.0999999999999999,0.8,0.8823529411764706,0.8333333333333334,0.8913043478260869,3.8378186490564894,5.420056470170918,7.215730246917135,3.941444182530816,25,17,24,46,12,9,12,12,75,80,76,54,13,8,12,34,0,3,0,0
1052,1.0999999999999999,0.7931034482758621,0.8448275862068966,0.9318181818181818,0.9038461538461539,3.7531798644866075,5.963200864133921,7.21156033301456,3.840345602029186,29,58,44,52,9,12,9,9,68,42,53,45,20,46,35,43,3,0,3,3
1053,1.0999999999999999,0.7142857142857143,0.9166666666666666,0.9285714285714286,0.8888888888888888,3.623807244770459,5.254318611374533,6.727737461587962,3.815990660324639,14,24,14,18,9,9,9,9,83,73,83,79,5,15,5,9,3,3,3,3
1054,1.0999999999999999,0.8461538461538461,0.875,0.9,0.8518518518518519,3.6414340864762775,5.394658804145628,7.238342187007818,3.9304639198512366,13,16,10,27,9,9,5,12,84,81,83,73,4,7,5,15,3,3,7,0
1055,1.0999999999999999,0.7333333333333333,0.7894736842105263,0.7333333333333333,0.918918918918919,3.622212923099689,5.286691702948218,6.621852437517378,3.932370935365888,15,19,15,37,5,5,5,12,78,74,78,63,10,14,10,25,7,7,7,0
1056,1.0999999999999999,1.0,0.9285714285714286,0.7777777777777778,1.0,3.897753284949299,6.071761889901343,6.981871691096799,4.382709731274887,9,28,9,30,9,8,5,9,88,68,84,67,0,20,4,21,3,4,7,3
1057,1.0999999999999999,0.7777777777777778,0.9375,0.8666666666666667,0.8157894736842105,3.571119344357556,4.912441161346942,6.620504072404886,3.8339520796078133,27,16,30,38,12,12,12,12,73,84,70,62,15,4,18,26,0,0,0,0
1058,1.0999999999999999,0.875,0.8974358974358975,0.8571428571428571,0.9411764705882353,3.466601223115607,5.577997769449505,6.119348003374376,3.479410879368138,24,39,28,34,9,9,9,9,73,58,69,63,15,30,19,25,3,3,3,3
1059,1.0999999999999999,0.8235294117647058,0.8653846153846154,0.9411764705882353,0.8421052631578947,3.594315533538829,5.852642491391337,6.852832193654788,3.921033926258215,17,52,17,38,8,12,8,9,79,48,79,59,9,40,9,29,4,0,4,3
1060,1.0999999999999999,0.8571428571428571,0.8529411764705882,1.0,0.868421052631579,3.4700277598167277,5.232881079140466,6.979716801791612,3.602998681636733,14,34,9,38,9,9,9,9,83,63,88,59,5,25,0,29,3,3,3,3
1061,1.0999999999999999,0.7333333333333333,0.8947368421052632,1.0,0.9285714285714286,3.6884991001847296,5.257254189968162,6.8697189433485075,4.09782841720316,15,19,11,14,5,12,5,8,78,81,82,82,10,7,6,6,7,0,7,4
1062,1.0999999999999999,0.9166666666666666,0.9090909090909091,1.0,0.8823529411764706,3.807164498563713,6.065913918578855,7.404200708641964,3.9335658723649525,12,22,5,17,9,9,5,9,85,75,88,80,3,13,0,8,3,3,7,3
1063,1.0999999999999999,0.8846153846153846,0.972972972972973,0.9047619047619048,0.9130434782608695,3.673475300586681,5.525079125848379,6.336380430623573,3.890739155940622,26,37,21,46,5,9,5,5,67,60,72,47,21,28,16,41,7,3,7,7
1064,1.0999999999999999,0.9411764705882353,0.6666666666666666,0.9444444444444444,0.9285714285714286,3.812946463870228,5.321518525274999,7.83105091835645,3.8915145906686557,17,12,18,14,12,9,12,9,83,85,82,83,5,3,6,5,0,3,0,3
1065,1.0999999999999999,0.875,0.8,0.7391304347826086,0.8787878787878788,3.772042149318974,5.35414163459073,6.680619104950937,4.109541248314352,8,5,23,33,8,5,5,9,88,88,70,64,0,0,18,24,4,7,7,3
1066,1.0999999999999999,0.7142857142857143,1.0,1.0,0.9130434782608695,3.699366424798977,5.416034520077594,7.326173442593995,3.9827355775203133,14,14,22,23,9,9,12,9,83,83,78,74,5,5,10,14,3,3,0,3
1067,1.0999999999999999,0.875,0.9090909090909091,1.0,0.9655172413793104,3.9853948604134217,6.0507206023403475,7.091326656089068,4.242765515314694,24,22,10,29,8,12,5,5,72,78,83,64,16,10,5,24,4,0,7,7
1068,1.0999999999999999,0.8461538461538461,0.9629629629629629,1.0,0.967741935483871,3.663077458299763,5.478634173096186,6.449662598037893,3.9241954257205918,13,27,15,31,9,5,5,9,84,66,78,66,4,22,10,22,3,7,7,3
1069,1.0999999999999999,0.8,0.8333333333333334,0.8,0.9166666666666666,3.897352322027993,5.7298522683268445,6.837338210773505,4.4277774367953455,5,12,5,12,5,8,5,8,88,84,88,84,0,4,0,4,7,4,7,4
1070,1.0999999999999999,0.8235294117647058,0.7857142857142857,1.0,0.9655172413793104,3.7716601439396946,5.1934234180311325,6.789912376691777,3.9977217894360124,17,14,9,29,9,9,9,9,80,83,88,68,8,5,0,20,3,3,3,3
1071,1.0999999999999999,0.8181818181818182,1.0,0.8461538461538461,0.8888888888888888,3.879012732138146,5.549575234928413,7.240683181360802,4.179119704839949,22,21,13,27,9,9,9,9,75,76,84,70,13,12,4,18,3,3,3,3
1072,1.0999999999999999,0.9,0.9285714285714286,1.0,0.92,3.684068875101887,5.848537422606215,6.815962667669448,4.151886371083671,10,28,5,25,5,9,5,5,83,69,88,68,5,19,0,20,7,3,7,7
1073,1.0999999999999999,0.9,0.92,0.9,0.9375,3.7543237831264156,5.3311480402376255,6.77214301102457,3.9456320924833204,10,25,10,32,5,12,5,9,83,75,83,65,5,13,5,23,7,0,7,3
1074,1.0999999999999999,0.7777777777777778,0.9230769230769231,0.7777777777777778,0.9444444444444444,3.4852899131935278,4.950477860932209,5.860434870286492,3.7398887032514714,9,13,9,36,9,9,9,12,88,84,88,64,0,4,0,24,3,3,3,0
1075,1.0999999999999999,0.8461538461538461,0.918918918918919,0.7272727272727273,0.8666666666666667,3.8191078082826477,6.147922372257331,6.612797114066691,4.176302279072063,13,37,11,30,9,9,3,12,84,60,80,70,4,28,8,18,3,3,9,0
1076,1.0999999999999999,1.0,0.9583333333333334,0.9545454545454546,0.9166666666666666,3.5281411796453455,5.3493381080858144,6.856562504285674,3.9306234855970863,9,24,22,48,9,9,12,9,88,73,78,49,0,15,10,39,3,3,0,3
1077,1.0999999999999999,0.7619047619047619,0.9032258064516129,1.0,0.8536585365853658,3.5866258813664045,5.568337118390986,7.306147204743734,4.065748527565358,21,31,19,41,9,9,9,12,76,66,78,59,12,22,10,29,3,3,3,0
1078,1.0999999999999999,0.9411764705882353,0.95,0.9411764705882353,0.9666666666666667,3.457658135310939,5.290379040548873,5.627651899475329,3.6660635496722653,17,20,17,30,9,5,9,9,80,73,80,67,8,15,8,21,3,7,3,3
1079,1.0999999999999999,0.5882352941176471,0.9705882352941176,0.7083333333333334,0.84,3.9243501018968527,6.237924717076529,7.444341282712294,4.172791790892173,17,34,24,25,9,9,12,12,80,63,76,75,8,25,12,13,3,3,0,0
1080,1.0999999999999999,0.9166666666666666,0.8695652173913043,0.9473684210526315,0.9459459459459459,3.55679646537952,5.23196995447346,7.054604909493352,3.8496563617749504,12,23,19,37,9,8,5,9,85,73,74,60,3,15,14,28,3,4,7,3
1081,1.0999999999999999,0.75,0.9090909090909091,1.0,0.9473684210526315,3.797078770418951,6.102960589939272,7.00642804639071,4.108222982561,12,44,12,19,9,9,12,9,85,53,88,78,3,35,0,10,3,3,0,3
1082,1.0999999999999999,0.8421052631578947,0.9166666666666666,0.8695652173913043,0.9545454545454546,3.4949877499205413,4.993986116098998,6.38587773269915,3.870946165257792,19,24,23,22,9,5,9,12,78,69,74,78,10,19,14,10,3,7,3,0
1083,1.0999999999999999,0.7894736842105263,0.7391304347826086,0.8666666666666667,0.8444444444444444,3.7673722255495354,5.436393466540481,6.631836809849431,3.930415499025669,19,23,15,45,9,9,5,12,78,74,78,55,10,14,10,33,3,3,7,0
1084,1.0999999999999999,0.6923076923076923,0.7692307692307693,0.7857142857142857,0.8461538461538461,3.6439807392920156,5.181507710248495,6.457817120283872,3.95263241186274,13,13,14,13,9,9,9,9,84,84,83,84,4,4,5,4,3,3,3,3
1085,1.0999999999999999,0.8823529411764706,0.9130434782608695,0.9629629629629629,0.8928571428571429,3.7525078028330876,5.975903785994288,7.81820408126432,3.7689814815016365,17,23,27,28,9,9,9,9,80,74,70,69,8,14,18,19,3,3,3,3
1086,1.0999999999999999,0.7692307692307693,1.0,0.8888888888888888,0.8333333333333334,3.632311893047273,4.904551408301817,6.141961059194914,3.882014454251035,13,9,9,24,5,9,5,5,80,88,84,69,8,0,4,19,7,3,7,7
1087,1.0999999999999999,0.9473684210526315,0.7777777777777778,0.9333333333333333,0.8666666666666667,3.689832308523575,5.3036021128978215,7.150854248280759,3.881390540663557,19,36,30,45,9,12,12,12,78,64,70,55,10,24,18,33,3,0,0,0
1088,1.0999999999999999,0.8888888888888888,0.8636363636363636,1.0,0.9090909090909091,3.6131904780166173,5.143576540873587,7.099207355544636,3.7913221992801316,9,22,9,22,9,9,9,12,88,75,88,78,0,13,0,10,3,3,3,0
1089,1.0999999999999999,0.8421052631578947,0.9666666666666667,0.8695652173913043,0.9722222222222222,3.755631917441969,5.775553570717482,6.840474625956653,3.9286421346765996,19,30,23,36,9,12,9,9,78,70,74,61,10,18,14,27,3,0,3,3
1090,1.0999999999999999,0.84375,0.9259259259259259,0.7777777777777778,0.875,3.8306161954555114,5.922396199284109,6.499256169907026,4.054723334787968,32,27,9,32,9,9,9,9,65,70,88,65,23,18,0,23,3,3,3,3
1091,1.0999999999999999,0.7586206896551724,0.8695652173913043,0.875,0.868421052631579,3.606121223712864,5.589622565702144,6.9404282304420075,3.713051811148644,29,23,32,38,9,9,8,5,68,74,64,55,20,14,24,33,3,3,4,7
1092,1.0999999999999999,0.7692307692307693,0.9285714285714286,0.7777777777777778,0.9423076923076923,3.4795558271180766,5.335024397716627,6.383786044610755,3.6632341576209084,13,42,18,52,8,8,8,8,83,54,78,44,5,34,10,44,4,4,4,4
1093,1.0999999999999999,0.7777777777777778,1.0,1.0,1.0,3.615167417449586,5.230220787812022,6.495410991935048,4.102893637312567,9,8,10,13,9,5,5,9,88,85,83,84,0,3,5,4,3,7,7,3
1094,1.0999999999999999,0.625,0.7647058823529411,1.0,1.0,3.8363389422600145,5.399074769235635,7.709423039636275,4.117412784166599,16,17,22,17,9,5,9,9,81,76,75,80,7,12,13,8,3,7,3,3
1095,1.0999999999999999,0.6666666666666666,0.8205128205128205,0.8787878787878788,0.7954545454545454,3.5907183891750076,5.5452233470446,6.545722184081834,3.700190676749411,36,39,33,44,9,9,12,9,61,58,67,53,27,30,21,35,3,3,0,3
1096,1.0999999999999999,0.8461538461538461,0.8928571428571429,0.90625,0.8846153846153846,3.637350683044413,5.46717720254927,6.944311598218526,3.7316722309073778,26,28,32,52,12,9,12,12,74,69,68,48,14,19,20,40,0,3,0,0
1097,1.0999999999999999,0.8888888888888888,0.8809523809523809,0.9583333333333334,0.8809523809523809,3.4606460587525927,5.477374594803296,6.57322351820297,3.720701572911922,9,42,24,42,9,9,9,9,88,55,73,55,0,33,15,33,3,3,3,3
1098,1.0999999999999999,0.7428571428571429,0.7631578947368421,0.7941176470588235,0.8611111111111112,3.8285947222080146,5.4461333968679035,6.75220307451891,3.8434388754604516,35,38,34,36,12,12,7,9,65,62,61,61,23,26,27,27,0,0,5,3
1099,1.0999999999999999,0.6923076923076923,0.9230769230769231,1.0,0.8837209302325582,3.728780139397072,5.267966480697491,7.270306365377695,4.115600528410067,13,26,24,43,9,12,9,12,84,74,73,57,4,14,15,31,3,0,3,0
1100,1.2,0.75,0.8918918918918919,0.75,0.9,3.6834957612342185,5.79055659888299,7.008642567048142,3.8477244029223145,16,37,16,50,9,9,9,9,81,60,81,47,7,28,7,41,3,3,3,3
1101,1.2,0.7391304347826086,0.9130434782608695,0.8333333333333334,0.8611111111111112,3.679635769579798,5.5850616897579,6.585999506211699,3.9134059526741094,23,23,24,36,9,9,9,12,74,74,73,64,14,14,15,24,3,3,3,0
1102,1.2,0.8421052631578947,0.9473684210526315,0.8947368421052632,1.0,3.6699186770616867,5.160301121209205,6.641253698299555,3.9201065412649583,19,19,19,23,9,5,9,5,78,74,78,70,10,14,10,18,3,7,3,7
1103,1.2,0.8076923076923077,1.0,0.9117647058823529,0.9722222222222222,3.676038089468648,5.390379011503151,7.158053280628247,4.046986252624342,26,13,34,36,9,9,9,12,71,84,63,64,17,4,25,24,3,3,3,0
1104,1.2,0.9444444444444444,0.9444444444444444,0.8888888888888888,0.9130434782608695,3.841256154918142,5.778551820119848,6.861210867415092,4.043126682883146,18,18,18,23,9,4,9,9,79,74,79,74,9,14,9,14,3,8,3,3
1105,1.2,0.7647058823529411,0.95,0.8571428571428571,0.9166666666666666,3.841053781144442,6.272144193460262,7.33012779198814,4.082135688971084,17,40,14,12,12,5,9,9,83,53,83,85,5,35,5,3,0,7,3,3
1106,1.2,0.7857142857142857,0.9166666666666666,0.9473684210526315,0.8571428571428571,3.714037398427346,5.705002743131689,6.961684916907546,3.7733568003661846,14,24,19,14,9,9,9,9,83,73,78,83,5,15,10,5,3,3,3,3
1107,1.2,0.8484848484848485,0.8947368421052632,0.7777777777777778,0.9444444444444444,3.6718861850312927,4.934498505655937,6.667648069828877,3.768456558953508,33,19,18,18,9,5,9,9,64,74,79,79,24,14,9,9,3,7,3,3
1108,1.2,0.8518518518518519,0.8888888888888888,0.8888888888888888,0.8846153846153846,3.603063323702529,5.169372327402001,7.300637297303315,3.6918814434754386,27,27,9,26,12,12,9,12,73,73,88,74,15,15,0,14,0,0,3,0
1109,1.2,0.8333333333333334,0.7741935483870968,0.7894736842105263,0.9230769230769231,3.8224259510743273,5.571628519589955,6.563225221539049,4.151730234925599,12,31,19,13,9,9,9,9,85,66,78,84,3,22,10,4,3,3,3,3
1110,1.2,0.7857142857142857,0.95,1.0,0.8536585365853658,3.664805823494516,5.416389241465508,6.335432922317231,3.9942077533503837,14,20,12,41,9,5,12,9,83,73,88,56,5,15,0,32,3,7,0,3
1111,1.2,0.8888888888888888,0.9230769230769231,0.8888888888888888,0.8125,3.58128034132633,5.323997524668524,6.097897345234976,3.8954689137635405,9,13,9,32,9,9,9,12,88,84,88,68,0,4,0,20,3,3,3,0
1112,1.2,0.896551724137931,0.9545454545454546,0.8928571428571429,0.9230769230769231,3.735511958418476,5.820154795822129,7.271554335644579,3.862825968204824,29,44,28,39,12,12,9,12,71,56,69,61,17,32,19,27,0,0,3,0
1113,1.2,0.918918918918919,0.92,1.0,0.9333333333333333,3.8513851055268686,5.697253172728486,8.066015865641292,4.089492044154345,37,25,36,45,12,9,8,12,63,72,60,55,25,16,28,33,0,3,4,0
1114,1.2,0.6923076923076923,0.9,0.8518518518518519,0.8333333333333334,3.764706007075916,5.611127372070179,7.468896004798417,4.070575024575943,13,40,27,30,5,9,5,5,80,57,66,63,8,31,22,25,7,3,7,7
1115,1.2,0.8333333333333334,0.896551724137931,0.9473684210526315,0.925,3.7166228668750745,5.806252750861663,6.466769261370896,3.875489927057852,12,29,19,40,5,9,5,9,81,68,74,57,7,20,14,31,7,3,7,3
1116,1.2,0.75,1.0,0.7777777777777778,0.9,3.875838815389658,5.410773530906731,7.050736068176756,4.118103029659813,12,12,9,30,9,9,9,9,85,85,88,67,3,3,0,21,3,3,3,3
1117,1.2,0.7142857142857143,0.9333333333333333,1.0,0.7619047619047619,3.6320920799815752,5.20811405849089,6.9743245016277955,4.0488793857976395,14,15,9,21,5,0,0,5,79,73,79,72,9,15,9,16,7,12,12,7
1118,1.2,0.9473684210526315,0.8947368421052632,0.85,0.9444444444444444,3.686568265812363,5.977831000247607,7.122194921565958,3.837582846795217,19,38,20,18,9,5,5,5,78,55,73,75,10,33,15,13,3,7,7,7
1119,1.2,0.95,0.8620689655172413,0.9310344827586207,0.9629629629629629,3.6513985325193516,5.583590719731979,7.297553860226645,3.8638427169985112,20,29,29,27,12,9,12,9,80,68,71,70,8,20,17,18,0,3,0,3
1120,1.2,0.8,1.0,0.9,0.8918918918918919,3.5750354085831884,5.188214791564693,6.012142742974674,3.740124426103365,25,16,20,37,5,8,5,8,68,80,73,59,20,8,15,29,7,4,7,4
1121,1.2,0.75,0.8823529411764706,0.625,0.8214285714285714,3.7502099245920437,5.767678644417039,6.50615389911529,3.9805656783781123,8,17,8,28,8,8,8,8,88,79,88,68,0,9,0,20,4,4,4,4
1122,1.2,0.868421052631579,0.8695652173913043,0.9137931034482759,0.84,3.737719322471976,5.463041008536842,7.048240465468222,3.7089039208495906,38,23,58,50,12,12,12,12,62,77,42,50,26,11,46,38,0,0,0,0
1123,1.2,0.8125,0.8461538461538461,1.0,0.9428571428571428,3.809659455538265,5.633421504699068,6.985849000670269,4.092632025720718,16,26,10,35,12,12,5,12,84,74,83,65,4,14,5,23,0,0,7,0
1124,1.2,0.9,1.0,0.8235294117647058,0.9387755102040817,3.7747674623968286,5.245127404058045,7.147188909158014,3.9734042900623443,10,12,34,49,5,9,9,12,83,85,63,51,5,3,25,37,7,3,3,0
1125,1.2,0.9230769230769231,0.9545454545454546,0.96,0.9696969696969697,3.699020741593649,5.614552352772539,6.884280348178563,3.835914312458867,13,22,25,33,9,9,12,9,84,75,75,64,4,13,13,24,3,3,0,3
1126,1.2,0.9090909090909091,0.9166666666666666,0.8333333333333334,0.9333333333333333,3.826150107371426,5.185205752500774,7.1641698349897025,4.104543339683874,11,12,12,30,8,8,8,8,85,84,84,66,3,4,4,22,4,4,4,4
1127,1.2,0.84375,0.9302325581395349,0.9130434782608695,0.9038461538461539,3.623591589240408,5.43389980562901,6.936943848834845,3.7264729579758926,32,43,23,52,5,5,5,5,61,50,70,41,27,38,18,47,7,7,7,7
1128,1.2,1.0,1.0,1.0,0.9393939393939394,3.5868699614409527,5.938641594588073,6.180166046374149,4.010755298030908,9,29,15,33,9,5,12,9,88,64,85,64,0,24,3,24,3,7,0,3
1129,1.2,0.8888888888888888,0.8863636363636364,0.8888888888888888,0.8823529411764706,3.6116602846482575,6.165203297944044,6.204955546410299,3.9196517698975497,18,44,9,17,9,5,9,9,79,49,88,80,9,39,0,8,3,7,3,3
1130,1.2,0.9473684210526315,0.9166666666666666,0.9310344827586207,0.9655172413793104,3.656791222067876,5.468891460357234,7.405662334650096,3.7965073331440244,19,24,29,29,9,9,9,9,78,73,68,68,10,15,20,20,3,3,3,3
1131,1.2,0.6666666666666666,0.875,0.8695652173913043,0.8064516129032258,3.7036561313303005,5.534187825839951,7.007893806273374,3.9158103912927578,27,24,23,31,12,9,8,12,73,73,73,69,15,15,15,19,0,3,4,0
1132,1.2,0.8108108108108109,0.9130434782608695,0.9428571428571428,0.8732394366197183,3.8344890301454346,5.475471763680224,6.968724152676271,3.89140164858941,37,46,35,71,9,9,9,9,60,51,62,26,28,37,26,62,3,3,3,3
1133,1.2,0.75,1.0,0.9166666666666666,0.9545454545454546,3.52486744753306,5.441291390205034,6.1314746299591825,3.8608326808768663,12,18,12,22,12,8,12,5,88,78,88,71,0,10,0,17,0,4,0,7
1134,1.2,0.75,0.8571428571428571,0.875,0.75,3.6123404618093233,5.549651510579823,6.996583586524349,3.7506697923511467,24,21,24,24,9,5,9,9,73,72,73,73,15,16,15,15,3,7,3,3
1135,1.2,0.8421052631578947,0.8928571428571429,0.7368421052631579,0.8636363636363636,3.7503191948130175,5.626374420361892,6.608346544009357,3.900261424891126,19,28,19,22,9,9,9,12,78,69,78,78,10,19,10,10,3,3,3,0
1136,1.2,0.9166666666666666,0.9375,1.0,0.8928571428571429,3.758063095301551,5.923151888482676,6.773678508060386,3.8335336060040652,12,48,12,28,12,8,12,8,88,48,88,68,0,40,0,20,0,4,0,4
1137,1.2,0.8260869565217391,0.8958333333333334,0.8947368421052632,0.9696969696969697,3.7550015877813574,5.98351642216365,6.895253515019238,4.034753355422544,23,48,19,33,9,12,9,9,74,52,78,64,14,36,10,24,3,0,3,3
1138,1.2,0.6428571428571429,0.7647058823529411,0.8387096774193549,0.8928571428571429,3.6212721487928876,5.055561351777009,7.029438870990576,3.776116972771142,14,17,31,28,9,9,9,9,83,80,66,69,5,8,22,19,3,3,3,3
1139,1.2,1.0,0.9230769230769231,0.8421052631578947,0.9411764705882353,3.9615976506860386,6.207400530254578,6.823827422356697,4.204096765934134,9,39,19,34,9,9,9,9,88,58,78,63,0,30,10,25,3,3,3,3
1140,1.2,0.9375,0.8888888888888888,0.9375,0.9,3.7378880356783197,5.365740272581978,6.519675597624176,4.086957743978156,16,18,16,30,9,5,9,12,81,75,81,70,7,13,7,18,3,7,3,0
1141,1.2,0.9166666666666666,0.9130434782608695,0.9333333333333333,0.90625,3.6766795473202136,5.901875390992579,6.644320122327935,3.8753753885825457,12,46,15,32,12,9,5,9,88,51,78,65,0,37,10,23,0,3,7,3
1142,1.2,0.9166666666666666,0.8333333333333334,0.8387096774193549,0.8636363636363636,3.790145580535562,5.559908802166122,6.637103785022868,4.0366980605751355,24,30,31,22,9,12,7,9,73,70,64,75,15,18,24,13,3,0,5,3
1143,1.2,0.6428571428571429,0.9142857142857143,0.9,0.9302325581395349,3.742060238497185,5.8248347898405415,7.088732080298288,3.954621250045449,14,35,20,43,9,5,5,9,83,58,73,54,5,30,15,34,3,7,7,3
1144,1.2,0.75,0.8333333333333334,0.8148148148148148,0.8823529411764706,3.7683773658664528,5.810576258120309,7.027685498726903,4.035383759508812,24,36,27,51,9,9,9,9,73,61,70,46,15,27,18,42,3,3,3,3
1145,1.2,0.8695652173913043,0.8666666666666667,0.8421052631578947,0.9019607843137255,4.010525874243531,5.9464376358332185,7.068368121355812,4.23591821971731,23,30,19,51,9,5,5,12,74,63,74,49,14,25,14,39,3,7,7,0
1146,1.2,0.8421052631578947,0.9130434782608695,0.9473684210526315,0.8928571428571429,3.794430573013875,5.586258695693822,7.208519367061348,4.041046854398536,19,23,19,28,9,9,9,9,78,74,78,69,10,14,10,19,3,3,3,3
1147,1.2,0.8888888888888888,1.0,0.6666666666666666,0.8888888888888888,3.7176834371194696,5.525002776875385,6.384217569979217,3.9443126454506943,9,24,9,63,9,9,9,9,88,73,88,34,0,15,0,54,3,3,3,3
1148,1.2,1.0,1.0,0.8,1.0,3.654585889177085,5.075698622281648,6.234898015236541,3.8960336611365287,5,10,5,18,5,5,5,5,88,83,88,75,0,5,0,13,7,7,7,7
1149,1.2,0.8947368421052632,0.9285714285714286,0.8888888888888888,0.875,3.787365664675755,5.410443082187385,6.23105762305378,4.000486182162469,19,28,9,24,9,9,9,9,78,69,88,73,10,19,0,15,3,3,3,3
1150,1.2,0.9166666666666666,0.7857142857142857,0.9655172413793104,0.9428571428571428,3.7812779680912727,5.351972138312255,8.114476441100077,3.8746413756691873,24,14,29,35,9,9,9,12,73,83,68,65,15,5,20,23,3,3,3,0
1151,1.2,0.8,0.8823529411764706,0.8333333333333334,0.8913043478260869,3.8378186490564894,5.421567862749569,7.215730246917135,3.9383063682775847,25,17,24,46,12,9,12,12,75,80,76,54,13,8,12,34,0,3,0,0
1152,1.2,0.7931034482758621,0.8448275862068966,0.9318181818181818,0.8076923076923077,3.7533348533881754,5.963200864133921,7.212166551872315,3.8099362788287348,29,58,44,52,9,12,9,9,68,42,53,45,20,46,35,43,3,0,3,3
1153,1.2,0.7142857142857143,0.9166666666666666,0.9285714285714286,0.8888888888888888,3.6241384323849544,5.255011666747745,6.728108434272849,3.808389176213535,14,24,14,18,9,9,9,9,83,73,83,79,5,15,5,9,3,3,3,3
1154,1.2,0.8461538461538461,0.875,0.9,0.8148148148148148,3.641937976753709,5.395414510108564,7.243734041014467,3.926092797749511,13,16,10,27,9,9,5,12,84,81,83,73,4,7,5,15,3,3,7,0
1155,1.2,0.7333333333333333,0.7894736842105263,0.7333333333333333,0.8648648648648649,3.622225964819561,5.285307266386574,6.6241562217144985,3.865976984306006,15,19,15,37,5,5,5,12,78,74,78,63,10,14,10,25,7,7,7,0
1156,1.2,1.0,0.9285714285714286,0.7777777777777778,1.0,3.8981836672835257,6.0773853650096346,6.98660397087525,4.369328744953124,9,28,9,30,9,8,5,9,88,68,84,67,0,20,4,21,3,4,7,3
1157,1.2,0.7777777777777778,0.9375,0.8666666666666667,0.8157894736842105,3.571119344357557,4.912441161346942,6.620504072404887,3.8306093089881834,27,16,30,38,12,12,12,12,73,84,70,62,15,4,18,26,0,0,0,0
1158,1.2,0.875,0.8974358974358975,0.8571428571428571,0.9411764705882353,3.466504906952546,5.577821349857174,6.118788526061176,3.4789066735045626,24,39,28,34,9,9,9,9,73,58,69,63,15,30,19,25,3,3,3,3
1159,1.2,0.8235294117647058,0.8653846153846154,0.9411764705882353,0.8947368421052632,3.596318785999868,5.852642491391337,6.859756869555188,3.9460007910322368,17,52,17,38,8,12,8,9,79,48,79,59,9,40,9,29,4,0,4,3
1160,1.2,0.8571428571428571,0.8529411764705882,1.0,0.868421052631579,3.469829491471842,5.232574945328664,6.978543579687288,3.6002210069942615,14,34,9,38,9,9,9,9,83,63,88,59,5,25,0,29,3,3,3,3
1161,1.2,0.7333333333333333,0.8947368421052632,1.0,0.9583333333333334,3.6890745638837736,5.257254189968162,6.871929938991737,4.036979385262932,15,19,11,24,5,12,5,8,78,81,82,72,10,7,6,16,7,0,7,4
1162,1.2,0.9166666666666666,0.9090909090909091,1.0,0.8823529411764706,3.8069941142628796,6.065285577720932,7.41434482722047,4.100391211797,12,22,5,17,9,9,5,9,85,75,88,80,3,13,0,8,3,3,7,3
1163,1.2,0.8846153846153846,0.972972972972973,0.9523809523809523,0.9130434782608695,3.674244420475578,5.524940664375792,6.3429765829051625,3.89019144312665,26,37,21,46,5,9,5,5,67,60,72,47,21,28,16,41,7,3,7,7
1164,1.2,0.9411764705882353,0.6666666666666666,0.8571428571428571,0.9285714285714286,3.812946463870228,5.322490504576819,7.857565160658317,3.887009808617838,17,12,28,14,12,9,12,9,83,85,72,83,5,3,16,5,0,3,0,3
1165,1.2,0.875,0.8,0.8518518518518519,0.9696969696969697,3.774061933171156,5.358151240426933,6.850959497945881,4.061265168352534,8,5,27,33,8,5,9,9,88,88,70,64,0,0,18,24,4,7,3,3
1166,1.2,0.8235294117647058,1.0,1.0,0.9130434782608695,3.68914932369414,5.416871627656134,7.326173442593997,3.9225633554418096,17,14,22,23,12,9,12,9,83,83,78,74,5,5,10,14,0,3,0,3
1167,1.2,0.875,0.9090909090909091,1.0,0.9615384615384616,3.9875754614805756,6.0507206023403475,7.09483450260381,4.260716266987,24,22,10,26,8,12,5,5,72,78,83,67,16,10,5,21,4,0,7,7
1168,1.2,0.8461538461538461,0.9629629629629629,1.0,0.9354838709677419,3.663444342204472,5.485339627063901,6.4560452315335874,3.965152912187746,13,27,15,31,9,5,5,9,84,66,78,66,4,22,10,22,3,7,7,3
1169,1.2,0.8,0.8333333333333334,0.8,0.9166666666666666,3.898855566546756,5.731725911104413,6.84079009736776,4.417545815724444,5,12,5,12,5,8,5,8,88,84,88,84,0,4,0,4,7,4,7,4
1170,1.2,0.8235294117647058,0.7857142857142857,1.0,0.9655172413793104,3.771385771217612,5.192696351270186,6.789284122295057,3.9908338047658316,17,14,9,29,9,9,9,9,80,83,88,68,8,5,0,20,3,3,3,3
1171,1.2,0.8181818181818182,1.0,0.8461538461538461,0.8888888888888888,3.8789610715412888,5.549137632925781,7.240062870958841,4.002282900571401,22,21,13,27,9,9,9,9,75,76,84,70,13,12,4,18,3,3,3,3
1172,1.2,0.9,0.9285714285714286,1.0,0.88,3.6851837151277684,5.847419531981968,6.817009655446048,3.9120337638105025,10,28,5,25,5,9,5,5,83,69,88,68,5,19,0,20,7,3,7,7
1173,1.2,0.9,0.92,0.9,0.9375,3.755823745664228,5.331148040237626,6.775198196702219,3.9158708529788306,10,25,10,32,5,12,5,9,83,75,83,65,5,13,5,23,7,0,7,3
1174,1.2,0.7777777777777778,0.9230769230769231,0.7777777777777778,0.9444444444444444,3.485575479817044,4.950704358907042,5.861206874074123,3.7372554103259867,9,13,9,36,9,9,9,12,88,84,88,64,0,4,0,24,3,3,3,0
1175,1.2,0.8461538461538461,0.918918918918919,0.7272727272727273,0.8666666666666667,3.819362774173837,6.14850964960617,6.639188190783714,4.118531203007627,13,37,11,30,9,9,3,12,84,60,80,70,4,28,8,18,3,3,9,0
1176,1.2,1.0,0.9583333333333334,0.9545454545454546,0.9166666666666666,3.5282619859324638,5.349958319350342,6.856562504285674,3.9304459169940458,9,24,22,48,9,9,12,9,88,73,78,49,0,15,10,39,3,3,0,3
1177,1.2,0.7619047619047619,0.9032258064516129,1.0,0.8536585365853658,3.58681305345105,5.568773445537128,7.307247962489065,3.858779183106946,21,31,19,41,9,9,9,12,76,66,78,59,12,22,10,29,3,3,3,0
1178,1.2,0.9411764705882353,0.95,0.9411764705882353,0.9696969696969697,3.4579388926898504,5.295239613011828,5.629123105310184,3.7267527011381723,17,20,17,33,9,5,9,12,80,73,80,67,8,15,8,21,3,7,3,0
1179,1.2,0.5882352941176471,0.9705882352941176,0.7083333333333334,0.84,3.924901378348203,6.238836608002476,7.444341282712294,4.168408281108012,17,34,24,25,9,9,12,12,80,63,76,75,8,25,12,13,3,3,0,0
1180,1.2,0.9166666666666666,0.9,0.9473684210526315,0.972972972972973,3.557172477241316,5.191003569145001,7.067055283214905,3.8233438862528937,12,20,19,37,9,8,5,9,85,76,74,60,3,12,14,28,3,4,7,3
1181,1.2,0.75,0.9090909090909091,1.0,0.9473684210526315,3.7970393306895946,6.102423152603996,7.00642804639071,4.1044593412112045,12,44,12,19,9,9,12,9,85,53,88,78,3,35,0,10,3,3,0,3
1182,1.2,0.8421052631578947,0.9166666666666666,0.8695652173913043,0.9545454545454546,3.4947835472037645,4.998902529851568,6.38647797090057,3.8709524347792286,19,24,23,22,9,5,9,12,78,69,74,78,10,19,14,10,3,7,3,0
1183,1.2,0.7894736842105263,0.7391304347826086,0.8666666666666667,0.8,3.7668784448032597,5.434636088011674,6.633107087980911,3.923082354012091,19,23,15,45,9,9,5,12,78,74,78,55,10,14,10,33,3,3,7,0
1184,1.2,0.6923076923076923,0.7692307692307693,0.7222222222222222,0.7692307692307693,3.643950730827822,5.181718358240122,6.4533118504290865,3.8054893871790907,13,13,18,13,9,9,9,9,84,84,79,84,4,4,9,4,3,3,3,3
1185,1.2,0.8823529411764706,0.9130434782608695,0.9629629629629629,0.8928571428571429,3.752886946120075,5.976529087921192,7.819719675440406,3.762944782180008,17,23,27,28,9,9,9,9,80,74,70,69,8,14,18,19,3,3,3,3
1186,1.2,0.7692307692307693,1.0,0.8888888888888888,0.9583333333333334,3.6339646932799385,4.905353591541847,6.143486702557351,3.8672524531812322,13,9,9,24,5,9,5,5,80,88,84,69,8,0,4,19,7,3,7,7
1187,1.2,0.9473684210526315,0.7777777777777778,0.9333333333333333,0.8666666666666667,3.689568619303369,5.3036021128978215,7.1508542482807576,3.879597894638449,19,36,30,45,9,12,12,12,78,64,70,55,10,24,18,33,3,0,0,0
1188,1.2,0.8888888888888888,0.8636363636363636,1.0,0.9090909090909091,3.6134801258863813,5.143775161135479,7.09938337018721,3.7869934082668775,9,22,9,22,9,9,9,12,88,75,88,78,0,13,0,10,3,3,3,0
1189,1.2,0.8421052631578947,0.9666666666666667,0.8076923076923077,0.9722222222222222,3.7564505191680726,5.775553570717481,6.77594200925679,3.9276419168396237,19,30,26,36,9,12,12,9,78,70,74,61,10,18,14,27,3,0,0,3
1190,1.2,0.84375,0.9259259259259259,0.7777777777777778,0.84375,3.830728247310525,5.922366969597667,6.499919519914766,4.086082347545443,32,27,9,32,9,9,9,9,65,70,88,65,23,18,0,23,3,3,3,3
1191,1.2,0.7586206896551724,0.8695652173913043,0.875,0.9285714285714286,3.6066885646608475,5.591155827410884,6.9520145047471775,3.8526982381028496,29,23,32,42,9,9,8,9,68,74,64,55,20,14,24,33,3,3,4,3
1192,1.2,0.7692307692307693,0.9285714285714286,0.7777777777777778,0.9423076923076923,3.4809878224537916,5.3398846672687466,6.3924555638282685,3.6636464997660547,13,42,18,52,8,8,8,8,83,54,78,44,5,34,10,44,4,4,4,4
1193,1.2,0.7777777777777778,1.0,1.0,1.0,3.6152668619621986,5.234231735525597,6.500425441456828,4.0893152145865015,9,8,10,13,9,5,5,9,88,85,83,84,0,3,5,4,3,7,7,3
1194,1.2,0.625,0.7647058823529411,1.0,0.9411764705882353,3.8363018567086993,5.406520723210376,7.710731196886932,4.109026928293099,16,17,22,17,9,5,9,9,81,76,75,80,7,12,13,8,3,7,3,3
1195,1.2,0.6666666666666666,0.8205128205128205,0.8787878787878788,0.8409090909090909,3.5911956950354806,5.546336916709952,6.545722184081834,3.6581142679200074,36,39,33,44,9,9,12,9,61,58,67,53,27,30,21,35,3,3,0,3
1196,1.2,0.8461538461538461,0.8928571428571429,0.90625,0.8846153846153846,3.637350683044413,5.46905067492825,6.944311598218526,3.7302689921623915,26,28,32,52,12,9,12,12,74,69,68,48,14,19,20,40,0,3,0,0
1197,1.2,0.8888888888888888,0.8809523809523809,0.9583333333333334,0.9285714285714286,3.460500459582249,5.477566588464723,6.5711265643441505,3.6478428745666993,9,42,24,42,9,9,9,9,88,55,73,55,0,33,15,33,3,3,3,3
1198,1.2,0.7428571428571429,0.7631578947368421,0.7941176470588235,0.8333333333333334,3.8285947222080146,5.4461333968679035,6.761926551108695,3.838902467287708,35,38,34,36,12,12,7,9,65,62,61,61,23,26,27,27,0,0,5,3
1199,1.2,0.6923076923076923,0.9230769230769231,1.0,0.8837209302325582,3.7290112231665153,5.267966480697491,7.272339312254474,4.170577383983531,13,26,24,43,9,12,9,12,84,74,73,57,4,14,15,31,3,0,3,0
1200,1.3,0.75,0.8918918918918919,0.75,0.96,3.683658051697029,5.791752149915289,7.0082290966087815,4.126743695267743,16,37,16,50,9,9,9,9,81,60,81,47,7,28,7,41,3,3,3,3
1201,1.3,0.7391304347826086,0.9130434782608695,0.8333333333333334,0.9722222222222222,3.680012076593522,5.585088539477409,6.585306055247745,3.847716288144244,23,23,24,36,9,9,9,12,74,74,73,64,14,14,15,24,3,3,3,0
1202,1.3,0.8421052631578947,0.9473684210526315,0.8947368421052632,1.0,3.670239302232674,5.166055228495695,6.641833535648196,3.919410110191422,19,19,19,23,9,5,9,5,78,74,78,70,10,14,10,18,3,7,3,7
1203,1.3,0.8076923076923077,1.0,0.9117647058823529,0.8888888888888888,3.6765546691579987,5.391710008362431,7.158325206492073,4.0104908054374695,26,13,34,36,9,9,9,12,71,84,63,64,17,4,25,24,3,3,3,0
1204,1.3,0.9444444444444444,0.9130434782608695,0.8888888888888888,0.9130434782608695,3.8410932002243623,5.647972839611546,6.861613439540934,4.03807432482398,18,23,18,23,9,9,9,9,79,74,79,74,9,14,9,14,3,3,3,3
1205,1.3,0.7647058823529411,0.95,0.8571428571428571,0.9166666666666666,3.841053781144442,6.284011447494135,7.329878451139877,4.0520819343487045,17,40,14,12,12,5,9,9,83,53,83,85,5,35,5,3,0,7,3,3
1206,1.3,0.7857142857142857,0.9166666666666666,0.9473684210526315,0.7857142857142857,3.714403369267843,5.7058119697401315,6.96120059115184,3.7694286989029018,14,24,19,14,9,9,9,9,83,73,78,83,5,15,10,5,3,3,3,3
1207,1.3,0.8484848484848485,0.8947368421052632,0.7777777777777778,0.9444444444444444,3.672192544451675,4.940208998732515,6.668680232744116,3.7336513759106698,33,19,18,18,9,5,9,9,64,74,79,79,24,14,9,9,3,7,3,3
1208,1.3,0.8518518518518519,0.8888888888888888,0.8888888888888888,0.8846153846153846,3.6030633237025294,5.169372327402001,7.301900312185249,3.689274909447499,27,27,9,26,12,12,9,12,73,73,88,74,15,15,0,14,0,0,3,0
1209,1.3,0.8333333333333334,0.7741935483870968,0.7894736842105263,0.9230769230769231,3.822759071675845,5.571020538153918,6.564432971103559,4.150404730005744,12,31,19,13,9,9,9,9,85,66,78,84,3,22,10,4,3,3,3,3
1210,1.3,0.7857142857142857,0.95,1.0,0.8536585365853658,3.6651495359067634,5.423284029316314,6.335432922317231,3.891492836281358,14,20,12,41,9,5,12,9,83,73,88,56,5,15,0,32,3,7,0,3
1211,1.3,0.8888888888888888,0.9230769230769231,0.8888888888888888,0.84375,3.581672025359557,5.324931553699618,6.099563743201782,3.836442939897131,9,13,9,32,9,9,9,12,88,84,88,68,0,4,0,20,3,3,3,0
1212,1.3,0.896551724137931,0.9545454545454546,0.8928571428571429,0.9487179487179487,3.7355119584184755,5.820154795822129,7.274209743861968,3.8942682739756127,29,44,28,39,12,12,9,12,71,56,69,61,17,32,19,27,0,0,3,0
1213,1.3,0.918918918918919,0.92,1.0,0.9333333333333333,3.8513851055268686,5.698534583205396,8.07337868066233,3.9531299059833587,37,25,36,45,12,9,8,12,63,72,60,55,25,16,28,33,0,3,4,0
1214,1.3,0.6923076923076923,0.9,0.8666666666666667,0.8666666666666667,3.7666765645262474,5.61230887845944,7.530779689810081,4.044927944800188,13,40,30,30,5,9,8,5,80,57,66,63,8,31,22,25,7,3,4,7
1215,1.3,0.8333333333333334,0.896551724137931,0.9473684210526315,0.925,3.7191115830452275,5.806564504402097,6.475251117506985,3.8745570991370597,12,29,19,40,5,9,5,9,81,68,74,57,7,20,14,31,7,3,7,3
1216,1.3,0.75,1.0,0.7777777777777778,0.9333333333333333,3.876043910747003,5.410958148263501,7.051901741985586,4.163308871474097,12,12,9,30,9,9,9,9,85,85,88,67,3,3,0,21,3,3,3,3
1217,1.3,0.7142857142857143,0.9333333333333333,1.0,0.7619047619047619,3.633353550435429,5.22357082515259,6.9935930193967835,4.0389343319540885,14,15,9,21,5,0,0,5,79,73,79,72,9,15,9,16,7,12,12,7
1218,1.3,0.9473684210526315,0.8947368421052632,0.85,0.9444444444444444,3.6869768294424374,5.982160921177189,7.1311852927424395,3.83736355513746,19,38,20,18,9,5,5,5,78,55,73,75,10,33,15,13,3,7,7,7
1219,1.3,0.95,0.8620689655172413,0.9310344827586207,0.9629629629629629,3.6513985325193516,5.5850974270528,7.297553860226644,3.8610301489215693,20,29,29,27,12,9,12,9,80,68,71,70,8,20,17,18,0,3,0,3
1220,1.3,0.8,1.0,0.9,0.8918918918918919,3.576919219016624,5.192651764760153,6.017723025703192,3.7386504085402628,25,16,20,37,5,8,5,8,68,80,73,59,20,8,15,29,7,4,7,4
1221,1.3,0.75,0.8823529411764706,0.625,0.8214285714285714,3.7523935681199214,5.769579718917193,6.5102847579087815,3.981700794521579,8,17,8,28,8,8,8,8,88,79,88,68,0,9,0,20,4,4,4,4
1222,1.3,0.868421052631579,0.8695652173913043,0.9137931034482759,0.84,3.737719322471977,5.463041008536842,7.048240465468222,3.7085510542977334,38,23,58,50,12,12,12,12,62,77,42,50,26,11,46,38,0,0,0,0
1223,1.3,0.8125,0.8461538461538461,1.0,1.0,3.8096594555382643,5.633421504699067,6.994162713186121,4.262147456626344,16,26,10,35,12,12,5,12,84,74,83,65,4,14,5,23,0,0,7,0
1224,1.3,0.9285714285714286,1.0,0.8235294117647058,0.9387755102040817,3.7535546177661034,5.2459595852117165,7.147553996584839,3.970880579708451,14,12,34,49,9,9,9,12,83,85,63,51,5,3,25,37,3,3,3,0
1225,1.3,0.9230769230769231,0.9545454545454546,0.96,0.9444444444444444,3.6997163119860366,5.6158385079579025,6.8842803481785655,3.7164171148733214,13,22,25,36,9,9,12,9,84,75,75,61,4,13,13,27,3,3,0,3
1226,1.3,0.9090909090909091,0.9166666666666666,0.8333333333333334,0.8666666666666667,3.827482555899233,5.189017517146262,7.169998368093111,4.050638905530108,11,12,12,30,8,8,8,8,85,84,84,66,3,4,4,22,4,4,4,4
1227,1.3,0.84375,0.9302325581395349,0.9130434782608695,0.8928571428571429,3.625439388329397,5.436866707682162,6.94034017513094,3.718482019239167,32,43,23,56,5,5,5,9,61,50,70,41,27,38,18,47,7,7,7,3
1228,1.3,1.0,1.0,1.0,0.9393939393939394,3.5870848884057858,5.946883962970674,6.180166046374149,4.00932529544957,9,29,15,33,9,5,12,9,88,64,85,64,0,24,3,24,3,7,0,3
1229,1.3,0.8888888888888888,0.8863636363636364,0.8888888888888888,0.8823529411764706,3.6123377564061467,6.1699237561015385,6.206420320490651,3.834003348110978,18,44,9,17,9,5,9,9,79,49,88,80,9,39,0,8,3,7,3,3
1230,1.3,0.9473684210526315,0.9166666666666666,0.9310344827586207,0.896551724137931,3.656927028642164,5.468213435348646,7.406763759556892,3.7873077339649903,19,24,29,29,9,9,9,9,78,73,68,68,10,15,20,20,3,3,3,3
1231,1.3,0.6666666666666666,0.875,0.8695652173913043,0.7741935483870968,3.7036561313303005,5.535361996458827,7.009913904294039,4.013403856555008,27,24,23,31,12,9,8,12,73,73,73,69,15,15,15,19,0,3,4,0
1232,1.3,0.8108108108108109,0.9130434782608695,0.9428571428571428,0.8591549295774648,3.834583371175311,5.475341873624057,6.968666783152462,3.890594067573144,37,46,35,71,9,9,9,9,60,51,62,26,28,37,26,62,3,3,3,3
1233,1.3,0.75,1.0,0.9166666666666666,0.8636363636363636,3.52486744753306,5.445175100988146,6.1314746299591825,4.017961187394454,12,18,12,22,12,8,12,5,88,78,88,71,0,10,0,17,0,4,0,7
1234,1.3,0.75,0.8571428571428571,0.875,0.75,3.612367083451941,5.555528063423832,6.996800496662069,3.7493055311608203,24,21,24,24,9,5,9,9,73,72,73,73,15,16,15,15,3,7,3,3
1235,1.3,0.8421052631578947,0.8928571428571429,0.7368421052631579,0.8636363636363636,3.7506204460432944,5.6271084903179,6.61023208786474,4.011053855220408,19,28,19,22,9,9,9,12,78,69,78,78,10,19,10,10,3,3,3,0
1236,1.3,0.9166666666666666,0.9423076923076923,1.0,0.90625,3.75806309530155,5.95665257447629,6.773678508060386,3.903057999047956,12,52,12,32,12,12,12,12,88,48,88,68,0,40,0,20,0,0,0,0
1237,1.3,0.8260869565217391,0.8958333333333334,0.8947368421052632,1.0,3.7554679021576316,5.983516422163649,6.8966184362291845,3.980298144240645,23,48,19,33,9,12,9,9,74,52,78,64,14,36,10,24,3,0,3,3
1238,1.3,0.6428571428571429,0.7647058823529411,0.8857142857142857,0.8928571428571429,3.6214646127754273,5.056103649486298,7.135876164290491,3.7746535972785424,14,17,35,28,9,9,9,9,83,80,62,69,5,8,26,19,3,3,3,3
1239,1.3,1.0,0.9230769230769231,0.8421052631578947,0.9411764705882353,3.9619532015477574,6.207862420705296,6.824243088338305,4.204817531312235,9,39,19,34,9,9,9,9,88,58,78,63,0,30,10,25,3,3,3,3
1240,1.3,0.9375,0.8888888888888888,0.9375,0.9,3.7382146621269428,5.371256052964557,6.520802155354232,4.081608170360433,16,18,16,30,9,5,9,12,81,75,81,70,7,13,7,18,3,7,3,0
1241,1.3,0.9166666666666666,0.9130434782608695,0.9333333333333333,0.875,3.6766795473202127,5.903930963904451,6.658638369173398,3.8824788816201705,12,46,15,32,12,9,5,9,88,51,78,65,0,37,10,23,0,3,7,3
1242,1.3,0.9166666666666666,0.8333333333333334,0.75,0.8636363636363636,3.7907372592017285,5.559908802166123,6.465141941691105,4.028100171004102,24,30,36,22,9,12,12,9,73,70,64,75,15,18,24,13,3,0,0,3
1243,1.3,0.6428571428571429,0.9142857142857143,0.9,0.9302325581395349,3.7418382801453864,5.826907754201489,7.088273896343571,3.9531784980515585,14,35,20,43,9,5,5,9,83,58,73,54,5,30,15,34,3,7,7,3
1244,1.3,0.75,0.8333333333333334,0.8148148148148148,0.8431372549019608,3.768842529100573,5.811944798543281,7.029823581210334,3.9509097851802037,24,36,27,51,9,9,9,9,73,61,70,46,15,27,18,42,3,3,3,3
1245,1.3,0.8695652173913043,0.8666666666666667,0.8421052631578947,0.9019607843137255,4.010995171714501,5.953147142801678,7.075424535758939,4.060205150192269,23,30,19,51,9,5,5,12,74,63,74,49,14,25,14,39,3,7,7,0
1246,1.3,0.8421052631578947,0.9130434782608695,0.9473684210526315,0.8571428571428571,3.794498823211658,5.586720585729962,7.207736357827772,3.9872616189141863,19,23,19,28,9,9,9,9,78,74,78,69,10,14,10,19,3,3,3,3
1247,1.3,0.8888888888888888,1.0,0.6666666666666666,0.8888888888888888,3.718108081458711,5.525956943041963,6.38591060001181,3.9427716653688245,9,24,9,63,9,9,9,9,88,73,88,34,0,15,0,54,3,3,3,3
1248,1.3,1.0,1.0,0.8,0.9090909090909091,3.656014074404479,5.078059984687158,6.238696548825587,4.156446343671012,5,10,5,22,5,5,5,9,88,83,88,75,0,5,0,13,7,7,7,3
1249,1.3,0.8947368421052632,0.9285714285714286,0.8888888888888888,0.8333333333333334,3.7873105217040117,5.410760120183525,6.2308727855270005,4.029430114888329,19,28,9,24,9,9,9,9,78,69,88,73,10,19,0,15,3,3,3,3
1250,1.3,0.9166666666666666,0.7857142857142857,0.9655172413793104,0.9428571428571428,3.781757106764861,5.352481986390211,8.114730206177644,3.8700995964003613,24,14,29,35,9,9,9,12,73,83,68,65,15,5,20,23,3,3,3,0
1251,1.3,0.85,0.8823529411764706,0.8333333333333334,0.8043478260869565,3.8314081972812852,5.423041105092397,7.215730246917135,3.8784819325088367,20,17,24,46,12,9,12,12,80,80,76,54,8,8,12,34,0,3,0,0
1252,1.3,0.7931034482758621,0.8448275862068966,0.9318181818181818,0.8076923076923077,3.753493190971147,5.96320086413392,7.212768622369027,3.8093940218434423,29,58,44,52,9,12,9,9,68,42,53,45,20,46,35,43,3,0,3,3
1253,1.3,0.7142857142857143,0.9166666666666666,0.9285714285714286,0.8888888888888888,3.6244646254506114,5.255688555030859,6.728478365527848,3.7985381084350553,14,24,14,18,9,9,9,9,83,73,83,79,5,15,5,9,3,3,3,3
1254,1.3,0.8461538461538461,0.875,0.9,0.8148148148148148,3.642431106153379,5.396152756664101,7.249089440145111,3.922530342274839,13,16,10,27,9,9,5,12,84,81,83,73,4,7,5,15,3,3,7,0
1255,1.3,0.7333333333333333,0.7894736842105263,0.7333333333333333,0.8648648648648649,3.6223388809764505,5.284112530110222,6.626544294764371,3.8654548346053645,15,19,15,37,5,5,5,12,78,74,78,63,10,14,10,25,7,7,7,0
1256,1.3,1.0,0.9285714285714286,0.7777777777777778,1.0,3.89861057049867,6.08286688595293,6.991258468394577,4.380031540173263,9,28,9,30,9,8,5,9,88,68,84,67,0,20,4,21,3,4,7,3
1257,1.3,0.7777777777777778,0.9375,0.8666666666666667,0.8157894736842105,3.5711193443575575,4.912441161346942,6.620504072404887,3.868140515595825,27,16,30,38,12,12,12,12,73,84,70,62,15,4,18,26,0,0,0,0
1258,1.3,0.875,0.8974358974358975,0.8571428571428571,0.9411764705882353,3.466433814793493,5.5776848514297175,6.118292144403783,3.4785227305348316,24,39,28,34,9,9,9,9,73,58,69,63,15,30,19,25,3,3,3,3
1259,1.3,0.8235294117647058,0.8653846153846154,0.9411764705882353,0.8421052631578947,3.598364934692357,5.852642491391338,6.866624509251568,3.917576431401624,17,52,17,38,8,12,8,9,79,48,79,59,9,40,9,29,4,0,4,3
1260,1.3,0.8571428571428571,0.8529411764705882,1.0,0.8947368421052632,3.4696502216135445,5.232299047763103,6.97743793474882,3.6144125839481243,14,34,9,38,9,9,9,9,83,63,88,59,5,25,0,29,3,3,3,3
1261,1.3,0.7333333333333333,0.8947368421052632,1.0,0.9583333333333334,3.689719139352282,5.257254189968162,6.874214845118487,4.0385006992655885,15,19,11,24,5,12,5,8,78,81,82,72,10,7,6,16,7,0,7,4
1262,1.3,0.9166666666666666,0.9090909090909091,1.0,0.8823529411764706,3.806838684437817,6.0646942475833105,7.424254954500336,3.9234942747728345,12,22,5,17,9,9,5,9,85,75,88,80,3,13,0,8,3,3,7,3
1263,1.3,0.8846153846153846,0.972972972972973,0.9523809523809523,0.9130434782608695,3.675072616816405,5.52482201462337,6.349463197585048,3.8909054250457302,26,37,21,46,5,9,5,5,67,60,72,47,21,28,16,41,7,3,7,7
1264,1.3,0.9411764705882353,0.6666666666666666,0.8571428571428571,0.9285714285714286,3.812946463870228,5.323435264722445,7.857565160658315,3.8834598686491275,17,12,28,14,12,9,12,9,83,85,72,83,5,3,16,5,0,3,0,3
1265,1.3,0.875,0.8,0.8518518518518519,0.8787878787878788,3.776107713171388,5.3621740316243836,6.849533610978081,4.103606781036961,8,5,27,33,8,5,9,9,88,88,70,64,0,0,18,24,4,7,3,3
1266,1.3,0.8235294117647058,1.0,1.0,0.9130434782608695,3.68914932369414,5.4177055287356435,7.326173442593995,3.974445384748904,17,14,22,23,12,9,12,9,83,83,78,74,5,5,10,14,0,3,0,3
1267,1.3,0.875,0.9090909090909091,1.0,0.9615384615384616,3.9898226156867196,6.0507206023403475,7.098503458420237,4.219368214514075,24,22,10,26,8,12,5,5,72,78,83,67,16,10,5,21,4,0,7,7
1268,1.3,0.8461538461538461,0.9629629629629629,1.0,0.9354838709677419,3.6638065336884864,5.491901862842614,6.46234226618663,3.9634024723079486,13,27,15,31,9,5,5,9,84,66,78,66,4,22,10,22,3,7,7,3
1269,1.3,0.8,0.8333333333333334,0.8,0.9166666666666666,3.9004072734094435,5.733674662915096,6.84430281931874,4.409348505324528,5,12,5,12,5,8,5,8,88,84,88,84,0,4,0,4,7,4,7,4
1270,1.3,0.8235294117647058,0.7857142857142857,1.0,0.9310344827586207,3.7711336835384315,5.192013420613209,6.788700813669616,3.9846133389893463,17,14,9,29,9,9,9,9,80,83,88,68,8,5,0,20,3,3,3,3
1271,1.3,0.8181818181818182,1.0,0.8461538461538461,0.8888888888888888,3.8789213532702997,5.548730911040753,7.2394829622896,4.179535941005245,22,21,13,27,9,9,9,9,75,76,84,70,13,12,4,18,3,3,3,3
1272,1.3,0.9,0.9285714285714286,1.0,0.88,3.6863356985401383,5.846357011216311,6.818138275903872,3.9062112463672127,10,28,5,25,5,9,5,5,83,69,88,68,5,19,0,20,7,3,7,7
1273,1.3,0.9,0.92,0.9,0.9375,3.757362081964218,5.3311480402376255,6.778296868602998,3.941773507632158,10,25,10,32,5,12,5,9,83,75,83,65,5,13,5,23,7,0,7,3
1274,1.3,0.7777777777777778,0.9230769230769231,0.7777777777777778,0.9444444444444444,3.4858589500786348,4.950933801811117,5.861964926049534,3.7348259217192754,9,13,9,36,9,9,9,12,88,84,88,64,0,4,0,24,3,3,3,0
1275,1.3,0.8461538461538461,0.918918918918919,0.8,0.8666666666666667,3.819622597192963,6.149096082337227,6.5677619628496995,4.1597902406272755,13,37,15,30,9,9,7,12,84,60,80,70,4,28,8,18,3,3,5,0
1276,1.3,1.0,0.9583333333333334,0.9545454545454546,0.9166666666666666,3.528388039479293,5.3505686684565745,6.856562504285674,3.9304848175835745,9,24,22,48,9,9,12,9,88,73,78,49,0,15,10,39,3,3,0,3
1277,1.3,0.7619047619047619,0.9032258064516129,1.0,0.8536585365853658,3.5870022273107813,5.569206144002875,7.308322185619846,3.853907076507989,21,31,19,41,9,9,9,12,76,66,78,59,12,22,10,29,3,3,3,0
1278,1.3,0.9411764705882353,0.95,0.9411764705882353,0.9696969696969697,3.4582190307056204,5.300068822413815,5.630552508564782,3.7228096899564664,17,20,17,33,9,5,9,12,80,73,80,67,8,15,8,21,3,7,3,0
1279,1.3,0.5882352941176471,0.9705882352941176,0.7083333333333334,0.84,3.925444787773743,6.239730099968771,7.444341282712294,4.163833837242207,17,34,24,25,9,9,12,12,80,63,76,75,8,25,12,13,3,3,0,0
1280,1.3,0.9166666666666666,0.9,0.9473684210526315,0.9459459459459459,3.557542388402723,5.199829855889058,7.079332843441097,3.84253788444248,12,20,19,37,9,8,5,9,85,76,74,60,3,12,14,28,3,4,7,3
1281,1.3,0.75,0.9090909090909091,1.0,0.9473684210526315,3.7970094342238077,6.101919776527755,7.0064280463907105,4.103141459532811,12,44,12,19,9,9,12,9,85,53,88,78,3,35,0,10,3,3,0,3
1282,1.3,0.8421052631578947,0.9166666666666666,0.8695652173913043,0.9090909090909091,3.494605149717401,5.003802090663471,6.38708437427584,3.634173865098076,19,24,23,22,9,5,9,12,78,69,74,78,10,19,14,10,3,7,3,0
1283,1.3,0.7894736842105263,0.7391304347826086,0.8666666666666667,0.75,3.76642378845053,5.432977762959109,6.634489402262118,3.9546887067609333,19,23,15,40,9,9,5,12,78,74,78,60,10,14,10,28,3,3,7,0
1284,1.3,0.6923076923076923,0.7692307692307693,0.7222222222222222,0.8461538461538461,3.6439319598997315,5.18193350658559,6.452663301116058,3.9164571115129028,13,13,18,13,9,9,9,9,84,84,79,84,4,4,9,4,3,3,3,3
1285,1.3,0.8823529411764706,0.9130434782608695,0.9629629629629629,0.8928571428571429,3.7532598454839143,5.977140528384389,7.821190251815284,3.7589058191613307,17,23,27,28,9,9,9,9,80,74,70,69,8,14,18,19,3,3,3,3
1286,1.3,0.7692307692307693,1.0,0.8888888888888888,0.875,3.635678116414254,4.906136506707319,6.145239176699729,3.8782143057138483,13,9,9,24,5,9,5,5,80,88,84,69,8,0,4,19,7,3,7,7
1287,1.3,0.9473684210526315,0.7777777777777778,0.9333333333333333,0.8666666666666667,3.689324419882522,5.3036021128978215,7.150854248280759,3.877265661152118,19,36,30,45,9,12,12,12,78,64,70,55,10,24,18,33,3,0,0,0
1288,1.3,0.8888888888888888,0.8636363636363636,1.0,0.9090909090909091,3.6137684076591845,5.143980502110319,7.0995695544879425,3.7871924823991523,9,22,9,22,9,9,9,12,88,75,88,78,0,13,0,10,3,3,3,0
1289,1.3,0.8421052631578947,0.9666666666666667,0.8076923076923077,0.9722222222222222,3.7572471314981297,5.775553570717482,6.77594200925679,3.9267386144053416,19,30,26,36,9,12,12,9,78,70,74,61,10,18,14,27,3,0,0,3
1290,1.3,0.84375,0.9259259259259259,0.7777777777777778,0.84375,3.8308461559377838,5.9223529407659266,6.50057380417201,4.085221206220188,32,27,9,32,9,9,9,9,65,70,88,65,23,18,0,23,3,3,3,3
1291,1.3,0.7586206896551724,0.8695652173913043,0.875,0.9285714285714286,3.607249321827098,5.592652136112716,6.9632566748196005,3.853362324749513,29,23,32,42,9,9,8,9,68,74,64,55,20,14,24,33,3,3,4,3
1292,1.3,0.7692307692307693,0.9285714285714286,0.7272727272727273,0.9761904761904762,3.482482850758863,5.344708584089034,6.29231308333861,3.753290170922579,13,42,22,42,8,8,12,8,83,54,78,54,5,34,10,34,4,4,0,4
1293,1.3,0.7777777777777778,1.0,1.0,1.0,3.6153781247254995,5.238258975021708,6.491341401839001,4.084675857246089,9,8,5,13,9,5,5,9,88,85,88,84,0,3,0,4,3,7,7,3
1294,1.3,0.625,0.7647058823529411,1.0,0.9411764705882353,3.8362847829622884,5.413931347539754,7.712014102266962,4.137751210705214,16,17,22,17,9,5,9,9,81,76,75,80,7,12,13,8,3,7,3,3
1295,1.3,0.6666666666666666,0.8205128205128205,0.8787878787878788,0.7954545454545454,3.591664845949713,5.547421969791343,6.545722184081833,3.6996868059188404,36,39,33,44,9,9,12,9,61,58,67,53,27,30,21,35,3,3,0,3
1296,1.3,0.8461538461538461,0.8928571428571429,0.90625,0.9038461538461539,3.637350683044413,5.470862457009644,6.944311598218526,3.7369395473633373,26,28,32,52,12,9,12,12,74,69,68,48,14,19,20,40,0,3,0,0
1297,1.3,0.8888888888888888,0.8809523809523809,0.9583333333333334,0.9285714285714286,3.4603698469111785,5.4777655525254385,6.569132179609322,3.647109056829445,9,42,24,42,9,9,9,9,88,55,73,55,0,33,15,33,3,3,3,3
1298,1.3,0.7428571428571429,0.7631578947368421,0.7941176470588235,0.8333333333333334,3.8285947222080146,5.446133396867904,6.7719473399454255,3.915227803437247,35,38,34,36,12,12,7,9,65,62,61,61,23,26,27,27,0,0,5,3
1299,1.3,0.6923076923076923,0.9230769230769231,1.0,0.8837209302325582,3.7292480996886845,5.267966480697491,7.274319904630968,4.169372220133331,13,26,24,43,9,12,9,12,84,74,73,57,4,14,15,31,3,0,3,0
1300,1.4,0.75,0.8918918918918919,0.75,0.9,3.6838228437504923,5.792914852389582,7.007845443346957,3.8460261019421518,16,37,16,50,9,9,9,9,81,60,81,47,7,28,7,41,3,3,3,3
1301,1.4,0.7391304347826086,0.9130434782608695,0.8888888888888888,0.8611111111111112,3.680389820836363,5.585134693790277,6.542452654967118,3.9105214182150356,23,23,27,36,9,9,12,12,74,74,73,64,14,14,15,24,3,3,0,0
1302,1.4,0.8421052631578947,0.9473684210526315,0.8947368421052632,1.0,3.6705552878766166,5.171775304777999,6.642405855870268,3.911330198091813,19,19,19,23,9,5,9,5,78,74,78,70,10,14,10,18,3,7,3,7
1303,1.4,0.8076923076923077,1.0,0.9117647058823529,0.8888888888888888,3.6770609080040058,5.3930039019659155,7.158604104181137,4.0062043895064,26,13,34,36,9,9,9,12,71,84,63,64,17,4,25,24,3,3,3,0
1304,1.4,0.9444444444444444,0.9130434782608695,0.8888888888888888,0.9130434782608695,3.840945078653627,5.647355351390208,6.862019924378716,4.031734787380031,18,23,18,23,9,9,9,9,79,74,79,74,9,14,9,14,3,3,3,3
1305,1.4,0.7647058823529411,0.95,0.8571428571428571,0.9166666666666666,3.841053781144441,6.29565789520805,7.329651361282957,4.081359511097599,17,40,14,12,12,5,9,9,83,53,83,85,5,35,5,3,0,7,3,3
1306,1.4,0.7857142857142857,0.9166666666666666,0.9473684210526315,0.7857142857142857,3.7147737125516533,5.70661583696332,6.960762729947456,3.7648627361695888,14,24,19,14,9,9,9,9,83,73,78,83,5,15,10,5,3,3,3,3
1307,1.4,0.8484848484848485,0.8947368421052632,0.7777777777777778,0.9444444444444444,3.6724958454199994,4.945910870024785,6.669688200825906,3.725577767491828,33,19,18,18,9,5,9,9,64,74,79,79,24,14,9,9,3,7,3,3
1308,1.4,0.8518518518518519,0.8888888888888888,0.8888888888888888,0.8846153846153846,3.603063323702529,5.169372327402001,7.303131189449827,3.6556158789762927,27,27,9,26,12,12,9,12,73,73,88,74,15,15,0,14,0,0,3,0
1309,1.4,0.8333333333333334,0.7741935483870968,0.8125,0.9230769230769231,3.82309672881549,5.570459692316626,6.407767893379722,4.149025964906177,12,31,16,13,9,9,9,9,85,66,81,84,3,22,7,4,3,3,3,3
1310,1.4,0.7857142857142857,0.95,1.0,0.8536585365853658,3.6654900603613236,5.430085130721643,6.3354329223172305,3.9909734852300027,14,20,12,41,9,5,12,9,83,73,88,56,5,15,0,32,3,7,0,3
1311,1.4,0.8333333333333334,0.9230769230769231,0.8888888888888888,0.8125,3.5689109788131397,5.325856723899018,6.101202518006648,3.8913012880324116,12,13,9,32,12,9,9,12,88,84,88,68,0,4,0,20,0,3,3,0
1312,1.4,0.896551724137931,0.9545454545454546,0.8928571428571429,0.9230769230769231,3.735511958418476,5.820154795822129,7.276786387913051,3.8587172650904895,29,44,28,39,12,12,9,12,71,56,69,61,17,32,19,27,0,0,3,0
1313,1.4,0.918918918918919,0.92,1.0,0.9333333333333333,3.8513851055268686,5.69978689209884,8.080594058536676,3.9514818262220475,37,25,36,45,12,9,8,12,63,72,60,55,25,16,28,33,0,3,4,0
1314,1.4,0.6923076923076923,0.9,0.8666666666666667,0.8666666666666667,3.7686441529745074,5.613462252841167,7.534686763618071,4.042690964956844,13,40,30,30,5,9,8,5,80,57,66,63,8,31,22,25,7,3,4,7
1315,1.4,0.875,0.896551724137931,0.9473684210526315,0.925,3.697433543644994,5.806889228527411,6.483583617411109,3.933385372773156,16,29,19,40,9,9,5,9,81,68,74,57,7,20,14,31,3,3,7,3
1316,1.4,0.75,1.0,0.7777777777777778,0.9,3.876254811840043,5.41115207165596,7.053045833614098,4.112897252558241,12,12,9,30,9,9,9,9,85,85,88,67,3,3,0,21,3,3,3,3
1317,1.4,0.7142857142857143,0.95,1.0,0.8571428571428571,3.634680026232484,5.17743955519216,7.012866005814663,3.9482297889270077,14,20,9,21,5,5,0,5,79,73,79,72,9,15,9,16,7,7,12,7
1318,1.4,0.9473684210526315,0.9047619047619048,0.85,0.9444444444444444,3.6873792880715115,6.115196330868447,7.140008629272176,3.837174704831674,19,42,20,18,9,9,5,5,78,55,73,75,10,33,15,13,3,3,7,7
1319,1.4,0.95,0.8620689655172413,0.9310344827586207,0.9629629629629629,3.6513985325193516,5.586572695299691,7.297553860226644,3.859529223081429,20,29,29,27,12,9,12,9,80,68,71,70,8,20,17,18,0,3,0,3
1320,1.4,0.8,1.0,0.9,0.8648648648648649,3.578831685362817,5.197040238031534,6.023285508986663,3.4981463948089098,25,16,20,37,5,8,5,8,68,80,73,59,20,8,15,29,7,4,7,4
1321,1.4,0.75,0.8823529411764706,0.625,0.8571428571428571,3.7545906346568705,5.771542002637595,6.514417614246311,3.9633908486188583,8,17,8,28,8,8,8,8,88,79,88,68,0,9,0,20,4,4,4,4
1322,1.4,0.868421052631579,0.8695652173913043,0.9137931034482759,0.84,3.737719322471976,5.463041008536842,7.048240465468222,3.7083769764422994,38,23,58,50,12,12,12,12,62,77,42,50,26,11,46,38,0,0,0,0
1323,1.4,0.8125,0.8461538461538461,1.0,0.9428571428571428,3.809659455538265,5.633421504699068,7.002348714431195,4.083305869294103,16,26,10,35,12,12,5,12,84,74,83,65,4,14,5,23,0,0,7,0
1324,1.4,0.9285714285714286,1.0,0.8235294117647058,0.9183673469387755,3.754136739772129,5.24677752539366,7.14793151323602,3.968420358063982,14,12,34,49,9,9,9,12,83,85,63,51,5,3,25,37,3,3,3,0
1325,1.4,0.9230769230769231,0.9545454545454546,0.96,0.9444444444444444,3.7003932670869877,5.617087142565333,6.884280348178563,3.753695065723679,13,22,25,36,9,9,12,9,84,75,75,61,4,13,13,27,3,3,0,3
1326,1.4,0.9090909090909091,0.9166666666666666,0.8333333333333334,0.9333333333333333,3.828844642425635,5.192815058707042,7.175735682727267,4.101924075349562,11,12,12,30,8,8,8,8,85,84,84,66,3,4,4,22,4,4,4,4
1327,1.4,0.7837837837837838,0.9302325581395349,0.9130434782608695,0.8928571428571429,3.6149658604668664,5.439868438963199,6.943768102240253,3.7175991971943354,37,43,23,56,5,5,5,9,56,50,70,41,32,38,18,47,7,7,7,3
1328,1.4,1.0,1.0,1.0,0.9393939393939394,3.587301183118693,5.954973422963528,6.180166046374149,4.007984233543998,9,29,15,33,9,5,12,9,88,64,85,64,0,24,3,24,3,7,0,3
1329,1.4,0.8888888888888888,0.8958333333333334,0.8888888888888888,0.8823529411764706,3.6130075230871594,6.211064945883687,6.207864772863761,3.825894678290816,18,48,9,17,9,9,9,9,79,49,88,80,9,39,0,8,3,3,3,3
1330,1.4,0.9473684210526315,0.9166666666666666,0.9310344827586207,0.9655172413793104,3.657072353408837,5.467581897860938,7.407850050346299,3.790271845760903,19,24,29,29,9,9,9,9,78,73,68,68,10,15,20,20,3,3,3,3
1331,1.4,0.6666666666666666,0.875,0.8695652173913043,0.8064516129032258,3.7036561313303,5.536504432852232,7.011991255311357,3.9082798876507323,27,24,23,31,12,9,8,12,73,73,73,69,15,15,15,19,0,3,4,0
1332,1.4,0.8108108108108109,0.8571428571428571,0.9428571428571428,0.8591549295774648,3.8346836490573906,5.468582974423958,6.968629531779401,3.889934977255439,37,56,35,71,9,9,9,9,60,41,62,26,28,47,26,62,3,3,3,3
1333,1.4,0.75,1.0,0.9166666666666666,0.9545454545454546,3.5248674475330604,5.449038231124506,6.1314746299591825,3.86146053011499,12,18,12,22,12,8,12,5,88,78,88,71,0,10,0,17,0,4,0,7
1334,1.4,0.75,0.8571428571428571,0.875,0.75,3.6124015313166224,5.561273241205414,6.997027522785689,3.7491362944464632,24,21,24,24,9,5,9,9,73,72,73,73,15,16,15,15,3,7,3,3
1335,1.4,0.8421052631578947,0.8928571428571429,0.7368421052631579,0.8636363636363636,3.7509246319558116,5.6278361062628415,6.612070822451993,3.895528727885264,19,28,19,22,9,9,9,12,78,69,78,78,10,19,10,10,3,3,3,0
1336,1.4,0.9166666666666666,0.9423076923076923,1.0,0.9375,3.758063095301551,5.95665257447629,6.773678508060385,3.9167571048980694,12,52,12,32,12,12,12,12,88,48,88,68,0,40,0,20,0,0,0,0
1337,1.4,0.8260869565217391,0.8958333333333334,0.8947368421052632,1.0,3.75593500677745,5.98351642216365,6.897967702821614,3.979993724118527,23,48,19,33,9,12,9,9,74,52,78,64,14,36,10,24,3,0,3,3
1338,1.4,0.6428571428571429,0.7647058823529411,0.8857142857142857,0.8571428571428571,3.6216644870454995,5.056647158990103,7.13443244941269,3.797463843127191,14,17,35,28,9,9,9,9,83,80,62,69,5,8,26,19,3,3,3,3
1339,1.4,1.0,0.9230769230769231,0.8421052631578947,0.9411764705882353,3.9623041628329023,6.208319453215893,6.824659451241901,4.203450711714853,9,39,19,34,9,9,9,9,88,58,78,63,0,30,10,25,3,3,3,3
1340,1.4,0.9375,0.8636363636363636,0.9375,0.9333333333333333,3.738542644442382,5.418970327003813,6.5219132160911215,4.0783098080174,16,22,16,30,9,9,9,12,81,75,81,70,7,13,7,18,3,3,3,0
1341,1.4,0.9166666666666666,0.9130434782608695,0.9333333333333333,0.90625,3.6766795473202136,5.905928617739445,6.672568764914917,3.870514562727158,12,46,15,32,12,9,5,9,88,51,78,65,0,37,10,23,0,3,7,3
1342,1.4,0.9166666666666666,0.8333333333333334,0.75,0.9545454545454546,3.7913164089500646,5.559908802166123,6.465141941691105,4.18134773691538,24,30,36,22,9,12,12,9,73,70,64,75,15,18,24,13,3,0,0,3
1343,1.4,0.6428571428571429,0.9142857142857143,0.9,0.9302325581395349,3.741633137276772,5.829095323311553,7.088108742543144,3.9510492342787606,14,35,20,43,9,5,5,9,83,58,73,54,5,30,15,34,3,7,7,3
1344,1.4,0.75,0.8333333333333334,0.8148148148148148,0.8431372549019608,3.7693082004998177,5.813289312946261,7.031919038249733,3.9503808329579875,24,36,27,51,9,9,9,9,73,61,70,46,15,27,18,42,3,3,3,3
1345,1.4,0.8695652173913043,0.8666666666666667,0.8421052631578947,0.9019607843137255,4.01145519098646,5.959826388730693,7.0825514259032225,4.236850592933564,23,30,19,51,9,5,5,12,74,63,74,49,14,25,14,39,3,7,7,0
1346,1.4,0.8421052631578947,0.9130434782608695,0.9473684210526315,0.8928571428571429,3.7945782119222913,5.587182099105971,7.207004843571181,4.034057889075781,19,23,19,28,9,9,9,9,78,74,78,69,10,14,10,19,3,3,3,3
1347,1.4,0.8888888888888888,1.0,0.6666666666666666,0.8888888888888888,3.718525314925349,5.526887337583678,6.387553934995341,3.941450620974167,9,24,9,63,9,9,9,9,88,73,88,34,0,15,0,54,3,3,3,3
1348,1.4,1.0,1.0,0.8,0.9545454545454546,3.657505514679477,5.080528276101647,6.242559155418703,4.080397060239087,5,10,5,22,5,5,5,9,88,83,88,75,0,5,0,13,7,7,7,3
1349,1.4,0.8947368421052632,0.9285714285714286,0.8888888888888888,0.875,3.7872656819078174,5.411076705375367,6.230706117371647,3.99664951718179,19,28,9,24,9,9,9,9,78,69,88,73,10,19,0,15,3,3,3,3
1350,1.4,0.9166666666666666,0.7857142857142857,0.9655172413793104,0.9142857142857143,3.7822361992896263,5.352997056925297,8.11500589839672,4.0405495919121055,24,14,29,35,9,9,9,12,73,83,68,65,15,5,20,23,3,3,3,0
1351,1.4,0.85,0.8823529411764706,0.8333333333333334,0.8913043478260869,3.8314081972812852,5.424480506479747,7.215730246917135,3.93133624187195,20,17,24,46,12,9,12,12,80,80,76,54,8,8,12,34,0,3,0,0
1352,1.4,0.7931034482758621,0.8448275862068966,0.9318181818181818,0.9038461538461539,3.7536544962869507,5.963200864133921,7.213367010243056,3.8389019132349365,29,58,44,52,9,12,9,9,68,42,53,45,20,46,35,43,3,0,3,3
1353,1.4,0.7142857142857143,0.95,0.9285714285714286,0.8888888888888888,3.6247863883275158,5.34210534937934,6.72884737131997,3.7888612195782687,14,20,14,18,9,5,9,9,83,73,83,79,5,15,5,9,3,7,3,3
1354,1.4,0.8461538461538461,0.875,0.9,0.8888888888888888,3.6429146915044566,5.396875519001098,7.2544121423718435,3.871424656857719,13,16,10,27,9,9,5,12,84,81,83,73,4,7,5,15,3,3,7,0
1355,1.4,0.7333333333333333,0.7894736842105263,0.7333333333333333,0.8648648648648649,3.622540335031457,5.283086061657118,6.629006918138549,3.8646223932986588,15,19,15,37,5,5,5,12,78,74,78,63,10,14,10,25,7,7,7,0
1356,1.4,1.0,0.9285714285714286,0.7777777777777778,1.0,3.8990343849165523,6.088222333843866,6.995843792350345,4.37898010337089,9,28,9,30,9,8,5,9,88,68,84,67,0,20,4,21,3,4,7,3
1357,1.4,0.7777777777777778,0.9375,0.8666666666666667,0.8157894736842105,3.571119344357557,4.912441161346942,6.620504072404887,3.825797146800288,27,16,30,38,12,12,12,12,73,84,70,62,15,4,18,26,0,0,0,0
1358,1.4,0.875,0.8974358974358975,0.8571428571428571,0.9411764705882353,3.4663850868912385,5.577583748446906,6.1178517110224835,3.478281320479427,24,39,28,34,9,9,9,9,73,58,69,63,15,30,19,25,3,3,3,3
1359,1.4,0.8235294117647058,0.8653846153846154,0.9411764705882353,0.8421052631578947,3.6004489175179755,5.852642491391338,6.873440955237039,3.9143976219812195,17,52,17,38,8,12,8,9,79,48,79,59,9,40,9,29,4,0,4,3
1360,1.4,0.8571428571428571,0.8529411764705882,1.0,0.868421052631579,3.4694877969535027,5.232049959575641,6.976392210855773,3.5962316052818144,14,34,9,38,9,9,9,9,83,63,88,59,5,25,0,29,3,3,3,3
1361,1.4,0.7333333333333333,0.8947368421052632,1.0,0.9117647058823529,3.6904249429572973,5.257254189968162,6.876565127233227,4.010405024269859,15,19,11,34,5,12,5,8,78,81,82,62,10,7,6,26,7,0,7,4
1362,1.4,0.9166666666666666,0.9090909090909091,1.0,0.8823529411764706,3.806696513823212,6.06413573339157,7.433956961926972,3.9223896705082373,12,22,5,17,9,9,5,9,85,75,88,80,3,13,0,8,3,3,7,3
1363,1.4,0.8846153846153846,0.972972972972973,0.9523809523809523,0.9130434782608695,3.6759531324992034,5.524720930344543,6.355852245246266,3.890798084426477,26,37,21,46,5,9,5,5,67,60,72,47,21,28,16,41,7,3,7,7
1364,1.4,0.9411764705882353,0.6666666666666666,0.8571428571428571,0.9285714285714286,3.8129464638702273,5.324355886812729,7.857565160658317,4.003560484288702,17,12,28,14,12,9,12,9,83,85,72,83,5,3,16,5,0,3,0,3
1365,1.4,0.9166666666666666,0.8,0.8518518518518519,0.8787878787878788,3.779962766128819,5.36620814433208,6.848182589017234,4.099353133991194,12,5,27,33,12,5,9,9,88,88,70,64,0,0,18,24,0,7,3,3
1366,1.4,0.8235294117647058,1.0,1.0,0.9130434782608695,3.68914932369414,5.4185365737614,7.326173442593995,3.9706537930100696,17,14,22,23,12,9,12,9,83,83,78,74,5,5,10,14,0,3,0,3
1367,1.4,0.8928571428571429,0.9090909090909091,1.0,0.9615384615384616,4.006487953725697,6.0507206023403475,7.102314813984914,4.257698929305022,28,22,10,26,12,12,5,5,72,78,83,67,16,10,5,21,0,0,7,7
1368,1.4,0.8461538461538461,0.9629629629629629,0.9,0.9354838709677419,3.664164562150686,5.498336691075223,6.5731667521684685,3.9622505448504284,13,27,20,31,9,5,5,9,84,66,73,66,4,22,15,22,3,7,7,3
1369,1.4,0.8,0.8333333333333334,0.8,0.9166666666666666,3.9020018246836066,5.735689861790519,6.847869189184346,4.411696774948402,5,12,5,12,5,8,5,8,88,84,88,84,0,4,0,4,7,4,7,4
1370,1.4,0.8235294117647058,0.7857142857142857,1.0,0.9655172413793104,3.770901355336766,5.1913696253092825,6.78815735756056,3.9875459646436684,17,14,9,29,9,9,9,9,80,83,88,68,8,5,0,20,3,3,3,3
1371,1.4,0.8181818181818182,1.0,0.8461538461538461,0.8888888888888888,3.8788922230789185,5.5483515694240975,7.2389388762422735,4.179847735728689,22,21,13,27,9,9,9,9,75,76,84,70,13,12,4,18,3,3,3,3
1372,1.4,0.9,0.9285714285714286,1.0,0.92,3.6875205407848854,5.845343585016913,6.819339212997329,4.139849845435986,10,28,5,25,5,9,5,5,83,69,88,68,5,19,0,20,7,3,7,7
1373,1.4,0.9,0.92,0.9,0.9375,3.758934326426206,5.3311480402376255,6.781433880985726,3.913926339815183,10,25,10,32,5,12,5,9,83,75,83,65,5,13,5,23,7,0,7,3
1374,1.4,0.7777777777777778,0.9230769230769231,0.7777777777777778,0.9444444444444444,3.486140559591762,4.951165854054631,5.862710602343207,3.733035249072795,9,13,9,36,9,9,9,12,88,84,88,64,0,4,0,24,3,3,3,0
1375,1.4,0.8461538461538461,0.918918918918919,0.8,0.8666666666666667,3.819886723550047,6.149681760120475,6.424171246255303,4.153652802507284,13,37,20,30,9,9,12,12,84,60,80,70,4,28,8,18,3,3,0,0
1376,1.4,1.0,0.9583333333333334,0.9545454545454546,0.9166666666666666,3.528518744120114,5.351170269090918,6.856562504285674,3.929883100950279,9,24,22,48,9,9,12,9,88,73,78,49,0,15,10,39,3,3,0,3
1377,1.4,0.7619047619047619,0.9032258064516129,1.0,0.8536585365853658,3.5871931744872203,5.569635622298984,7.3093728762261945,3.8498233705966896,21,31,19,41,9,9,9,12,76,66,78,59,12,22,10,29,3,3,3,0
1378,1.4,0.9411764705882353,0.9629629629629629,0.9411764705882353,0.9696969696969697,3.4584986171676557,5.305297560488295,5.63194483767419,3.7196533662499833,17,27,17,33,9,12,9,12,80,73,80,67,8,15,8,21,3,0,3,0
1379,1.4,0.5882352941176471,0.9705882352941176,0.7083333333333334,0.84,3.925981216836282,6.240607272329121,7.444341282712294,4.159674493180736,17,34,24,25,9,9,12,12,80,63,76,75,8,25,12,13,3,3,0,0
1380,1.4,0.9166666666666666,0.9,0.9473684210526315,0.8108108108108109,3.5579068881452156,5.20858130250023,7.091455576136971,10.418648122774142,12,20,19,37,9,8,5,9,85,76,74,60,3,12,14,28,3,4,7,3
1381,1.4,0.75,0.9090909090909091,1.0,0.9473684210526315,3.796987998776121,6.101446601174228,7.00642804639071,4.101345000885923,12,44,12,19,9,9,12,9,85,53,88,78,3,35,0,10,3,3,0,3
1382,1.4,0.8421052631578947,0.9166666666666666,0.8695652173913043,0.9090909090909091,3.49444963305088,5.008686210273894,6.387696235470318,3.6369792777112635,19,24,23,22,9,5,9,12,78,69,74,78,10,19,14,10,3,7,3,0
1383,1.4,0.7894736842105263,0.8148148148148148,0.8666666666666667,0.8648648648648649,3.7660038252664862,5.523781002504136,6.635970950647725,3.909749095678913,19,27,15,37,9,9,5,9,78,70,78,60,10,18,10,28,3,3,7,3
1384,1.4,0.6923076923076923,0.7692307692307693,0.7222222222222222,0.8461538461538461,3.643923152064204,5.182152643334102,6.452054714842138,3.916728799357862,13,13,18,13,9,9,9,9,84,84,79,84,4,4,9,4,3,3,3,3
1385,1.4,0.8823529411764706,0.9130434782608695,0.9629629629629629,0.8928571428571429,3.7536272065739182,5.977739676263351,7.822620907581892,3.747005132152094,17,23,27,28,9,9,9,9,80,74,70,69,8,14,18,19,3,3,3,3
1386,1.4,0.7692307692307693,1.0,0.8888888888888888,0.875,3.63744511900919,4.906902333241641,6.147192525691157,3.8776218327644703,13,9,9,24,5,9,5,5,80,88,84,69,8,0,4,19,7,3,7,7
1387,1.4,0.9473684210526315,0.7777777777777778,0.9333333333333333,0.8888888888888888,3.689097501284394,5.3036021128978215,7.1508542482807576,3.8381610240669133,19,36,30,45,9,12,12,12,78,64,70,55,10,24,18,33,3,0,0,0
1388,1.4,0.8888888888888888,0.8636363636363636,1.0,0.9090909090909091,3.614055475962689,5.14419179987597,7.099764753717453,3.784810537894506,9,22,9,22,9,9,9,12,88,75,88,78,0,13,0,10,3,3,3,0
1389,1.4,0.8421052631578947,0.9666666666666667,0.8076923076923077,0.9722222222222222,3.7580242417734073,5.775553570717482,6.77594200925679,3.9265629139326146,19,30,26,36,9,12,12,9,78,70,74,61,10,18,14,27,3,0,0,3
1390,1.4,0.8275862068965517,0.9259259259259259,0.7777777777777778,0.875,3.8151178002754107,5.922352388765473,6.501220045896673,4.053923183775556,29,27,9,32,9,9,9,9,68,70,88,65,20,18,0,23,3,3,3,3
1391,1.4,0.7586206896551724,0.8695652173913043,0.875,0.9285714285714286,3.607804234796603,5.59411566401256,6.974193190511315,3.851848762494919,29,23,32,42,9,9,8,9,68,74,64,55,20,14,24,33,3,3,4,3
1392,1.4,0.7692307692307693,0.9333333333333333,0.7272727272727273,0.9347826086956522,3.4840336180359652,5.396740031142478,6.29231308333861,3.6295244382712437,13,45,22,46,8,8,12,12,83,51,78,54,5,37,10,34,4,4,0,0
1393,1.4,0.7777777777777778,1.0,1.0,1.0,3.615499863931428,5.242300274254698,6.496159809726403,4.075099003479208,9,8,5,13,9,5,5,9,88,85,88,84,0,3,0,4,3,7,7,3
1394,1.4,0.625,0.7647058823529411,1.0,0.9411764705882353,3.836285451467418,5.421309628898521,7.713274606877207,4.133012146275497,16,17,22,17,9,5,9,9,81,76,75,80,7,12,13,8,3,7,3,3
1395,1.4,0.6666666666666666,0.8205128205128205,0.8787878787878788,0.8723404255319149,3.592126762755211,5.548481731480619,6.545722184081834,3.682789701811733,36,39,33,47,9,9,12,12,61,58,67,53,27,30,21,35,3,3,0,0
1396,1.4,0.8461538461538461,0.8928571428571429,0.90625,0.8846153846153846,3.6373506830444127,5.472619532178213,6.944311598218526,3.7271245294784947,26,28,32,52,12,9,12,12,74,69,68,48,14,19,20,40,0,3,0,0
1397,1.4,0.8888888888888888,0.8809523809523809,0.9583333333333334,0.9285714285714286,3.4602525218833646,5.477970694893477,6.567228744594526,3.6465571618940777,9,42,24,42,9,9,9,9,88,55,73,55,0,33,15,33,3,3,3,3
1398,1.4,0.7428571428571429,0.7631578947368421,0.7941176470588235,0.8333333333333334,3.8285947222080146,5.4461333968679035,6.782228872140204,3.909639102112978,35,38,34,36,12,12,7,9,65,62,61,61,23,26,27,27,0,0,5,3
1399,1.4,0.6923076923076923,0.9230769230769231,1.0,0.8837209302325582,3.7294901092511066,5.267966480697491,7.276254057454682,4.168488049757866,13,26,24,43,9,12,9,12,84,74,73,57,4,14,15,31,3,0,3,0
1400,1.5,0.75,0.8918918918918919,0.75,0.9,3.683989872561934,5.7940481627927225,7.0074884656606695,3.845551764946167,16,37,16,50,9,9,9,9,81,60,81,47,7,28,7,41,3,3,3,3
1401,1.5,0.7391304347826086,0.9130434782608695,0.8888888888888888,0.9722222222222222,3.680768846290892,5.5851981168513305,6.542452654967118,3.846027162843565,23,23,27,36,9,9,12,12,74,74,73,64,14,14,15,24,3,3,0,0
1402,1.5,0.8421052631578947,0.9473684210526315,0.8947368421052632,1.0,3.6708671213663333,5.177464372723901,6.642971448073759,3.9106168691997105,19,19,19,23,9,5,9,5,78,74,78,70,10,14,10,18,3,7,3,7
1403,1.5,0.8076923076923077,1.0,0.9117647058823529,0.9722222222222222,3.6775578927677,5.394264595469253,7.158889236746797,4.034510605865509,26,13,34,36,9,9,9,12,71,84,63,64,17,4,25,24,3,3,3,0
1404,1.5,0.9444444444444444,0.9130434782608695,0.8888888888888888,0.9130434782608695,3.8408102272110813,5.64677213507366,6.862429906231137,3.936601488143026,18,23,18,23,9,9,9,9,79,74,79,74,9,14,9,14,3,3,3,3
1405,1.5,0.7647058823529411,0.95,0.8571428571428571,0.9166666666666666,3.841053781144441,6.307105644440794,7.3294441774954056,4.050629994294618,17,40,14,12,12,5,9,9,83,53,83,85,5,35,5,3,0,7,3,3
1406,1.5,0.7857142857142857,0.9166666666666666,0.9473684210526315,0.8333333333333334,3.715147962208284,5.707414899956594,6.960366439258818,3.9614043149819467,14,24,19,24,9,9,9,9,83,73,78,73,5,15,10,15,3,3,3,3
1407,1.5,0.8484848484848485,0.8947368421052632,0.7777777777777778,0.9444444444444444,3.6727964084413225,4.951604362948403,6.670674518813682,3.7520496685925226,33,19,18,18,9,5,9,9,64,74,79,79,24,14,9,9,3,7,3,3
1408,1.5,0.8518518518518519,0.8888888888888888,0.8888888888888888,0.8846153846153846,3.603063323702529,5.169372327402001,7.304333310198315,3.6527401099328114,27,27,9,26,12,12,9,12,73,73,88,74,15,15,0,14,0,0,3,0
1409,1.5,0.8333333333333334,0.7741935483870968,0.8125,0.9230769230769231,3.8234384399644,5.569941019137667,6.408773385594257,4.147541074195219,12,31,16,13,9,9,9,9,85,66,81,84,3,22,7,4,3,3,3,3
1410,1.5,0.7857142857142857,0.95,1.0,0.8536585365853658,3.66582773044031,5.43680184109175,6.3354329223172305,3.8903892036704866,14,20,12,41,9,5,12,9,83,73,88,56,5,15,0,32,3,7,0,3
1411,1.5,0.8333333333333334,0.9230769230769231,0.8888888888888888,0.84375,3.5689109788131397,5.326773956485665,6.102816555612995,3.8341849741479246,12,13,9,32,12,9,9,12,88,84,88,68,0,4,0,20,0,3,3,0
1412,1.5,0.896551724137931,0.9545454545454546,0.8928571428571429,0.9230769230769231,3.7355119584184755,5.820154795822129,7.279292550998018,3.8572001687787134,29,44,28,39,12,12,9,12,71,56,69,61,17,32,19,27,0,0,3,0
1413,1.5,0.918918918918919,0.92,1.0,0.9555555555555556,3.8513851055268686,5.701013155893417,8.087677218726423,4.077590772009027,37,25,36,45,12,9,8,12,63,72,60,55,25,16,28,33,0,3,4,0
1414,1.5,0.6923076923076923,0.9,0.8666666666666667,0.8666666666666667,3.770608981361917,5.614590451848706,7.538538760584518,4.04111372460221,13,40,30,30,5,9,8,5,80,57,66,63,8,31,22,25,7,3,4,7
1415,1.5,0.875,0.896551724137931,0.9473684210526315,0.925,3.697988781350761,5.8072255518243505,6.491781895457527,3.87177466383474,16,29,19,40,9,9,5,9,81,68,74,57,7,20,14,31,3,3,7,3
1416,1.5,0.75,1.0,0.7777777777777778,0.9333333333333333,3.876470904483932,5.411354318275179,7.054170608412503,4.155681516241278,12,12,9,30,9,9,9,9,85,85,88,67,3,3,0,21,3,3,3,3
1417,1.5,0.7142857142857143,0.95,1.0,0.8571428571428571,3.636064538924346,5.180996091264694,7.032137387629187,3.9414489726552016,14,20,9,21,5,5,0,5,79,73,79,72,9,15,9,16,7,7,12,7
1418,1.5,0.9473684210526315,0.9047619047619048,0.85,0.9444444444444444,3.6877762825380596,6.115666119830148,7.1486819477022845,3.836826171479978,19,42,20,18,9,9,5,5,78,55,73,75,10,33,15,13,3,3,7,7
1419,1.5,0.95,0.8620689655172413,0.9310344827586207,0.9629629629629629,3.6513985325193516,5.588019820470234,7.297553860226644,3.8590719052682334,20,29,29,27,12,9,12,9,80,68,71,70,8,20,17,18,0,3,0,3
1420,1.5,0.8,1.0,0.9,0.8648648648648649,3.5807696375272378,5.201385044422217,6.0288315724710575,3.606598430587948,25,16,20,37,5,8,5,8,68,80,73,59,20,8,15,29,7,4,7,4
1421,1.5,0.75,0.9523809523809523,0.625,0.8571428571428571,3.756799552409652,5.844956639860446,6.518551977847636,3.962951302286341,8,21,8,28,8,12,8,8,88,79,88,68,0,9,0,20,4,0,4,4
1422,1.5,0.868421052631579,0.8695652173913043,0.9137931034482759,0.84,3.737719322471976,5.463041008536842,7.048240465468222,3.707887102748799,38,23,58,50,12,12,12,12,62,77,42,50,26,11,46,38,0,0,0,0
1423,1.5,0.8125,0.8461538461538461,1.0,0.9428571428571428,3.809659455538265,5.633421504699067,7.010419862142927,4.080329624101963,16,26,10,35,12,12,5,12,84,74,83,65,4,14,5,23,0,0,7,0
1424,1.5,0.9285714285714286,1.0,0.9032258064516129,0.9591836734693877,3.7547110985353442,5.247582718617639,7.2067295478567015,4.075228509241775,14,12,31,49,9,9,9,12,83,85,66,51,5,3,22,37,3,3,3,0
1425,1.5,0.9230769230769231,0.9545454545454546,0.96,0.9444444444444444,3.7010535656869865,5.6183022057093375,6.884280348178563,3.7126391446542493,13,22,25,36,9,9,12,9,84,75,75,61,4,13,13,27,3,3,0,3
1426,1.5,0.9090909090909091,0.9166666666666666,0.8333333333333334,0.9333333333333333,3.8302331627230757,5.1965996120924585,7.18139110886899,4.100593124582343,11,12,12,30,8,8,8,8,85,84,84,66,3,4,4,22,4,4,4,4
1427,1.5,0.7837837837837838,0.9302325581395349,0.9130434782608695,0.9107142857142857,3.616563394824756,5.44290110117267,6.947224078156706,3.716194671334126,37,43,23,56,5,5,5,9,56,50,70,41,32,38,18,47,7,7,7,3
1428,1.5,1.0,1.0,1.0,0.9696969696969697,3.587518699774926,5.9629254962703895,6.180166046374149,4.19831833336592,9,29,15,33,9,5,12,9,88,64,85,64,0,24,3,24,3,7,0,3
1429,1.5,0.8888888888888888,0.8958333333333334,0.8888888888888888,0.8823529411764706,3.613670387821142,6.2118106206513035,6.209291023410814,3.8175434864595617,18,48,9,17,9,9,9,9,79,49,88,80,9,39,0,8,3,3,3,3
1430,1.5,0.9473684210526315,0.9166666666666666,0.9310344827586207,0.9655172413793104,3.657226191194485,5.466991953220507,7.40892279184782,3.787778021353227,19,24,29,29,9,9,9,9,78,73,68,68,10,15,20,20,3,3,3,3
1431,1.5,0.6666666666666666,0.875,0.8695652173913043,0.8064516129032258,3.7036561313303014,5.537618473647058,7.014119712503067,3.9039254696666954,27,24,23,31,12,9,8,12,73,73,73,69,15,15,15,19,0,3,4,0
1432,1.5,0.8108108108108109,0.8571428571428571,0.9428571428571428,0.8732394366197183,3.834789237146931,5.468588212713895,6.968610277670036,3.889293456696569,37,56,35,71,9,9,9,9,60,41,62,26,28,47,26,62,3,3,3,3
1433,1.5,0.75,1.0,0.9166666666666666,0.8636363636363636,3.5248674475330604,5.452882701107241,6.1314746299591825,4.016962796456889,12,18,12,22,12,8,12,5,88,78,88,71,0,10,0,17,0,4,0,7
1434,1.5,0.75,0.8571428571428571,0.875,0.9166666666666666,3.6124429800114535,5.566900634321709,6.997263596659384,3.7700326873658923,24,21,24,24,9,5,9,9,73,72,73,73,15,16,15,15,3,7,3,3
1435,1.5,0.8421052631578947,0.8928571428571429,0.7368421052631579,0.8636363636363636,3.7512314398930884,5.628557940997585,6.613867664149371,3.8941602272956954,19,28,19,22,9,9,9,12,78,69,78,78,10,19,10,10,3,3,3,0
1436,1.5,0.9166666666666666,0.9047619047619048,1.0,0.9375,3.758063095301551,5.812627731859598,6.773678508060385,3.911161687261039,12,42,12,32,12,12,12,12,88,58,88,68,0,30,0,20,0,0,0,0
1437,1.5,0.8260869565217391,0.8958333333333334,0.8947368421052632,0.9696969696969697,3.756402811933686,5.98351642216365,6.899302945737934,4.032986352339299,23,48,19,33,9,12,9,9,74,52,78,64,14,36,10,24,3,0,3,3
1438,1.5,0.6428571428571429,0.7647058823529411,0.8857142857142857,0.8571428571428571,3.6218709880396553,5.057191746014652,7.133061750921925,3.798843391802619,14,17,35,28,9,9,9,9,83,80,62,69,5,8,26,19,3,3,3,3
1439,1.5,1.0,0.9230769230769231,0.8421052631578947,0.9411764705882353,3.9626510162573476,6.20877213739609,6.8250764347953465,4.196442617466629,9,39,19,34,9,9,9,9,88,58,78,63,0,30,10,25,3,3,3,3
1440,1.5,0.9375,0.8636363636363636,0.9375,0.9333333333333333,3.7388718363161253,5.41955389995197,6.523010400892875,4.073971375605248,16,22,16,30,9,9,9,12,81,75,81,70,7,13,7,18,3,3,3,0
1441,1.5,0.9166666666666666,0.9347826086956522,0.9333333333333333,0.875,3.6766795473202123,5.9078744405626376,6.68615131222867,3.8800100640502055,12,46,15,32,12,9,5,9,88,51,78,65,0,37,10,23,0,3,7,3
1442,1.5,0.9166666666666666,0.8333333333333334,0.75,0.8636363636363636,3.7918843465782435,5.559908802166123,6.465141941691106,4.015263758038242,24,30,36,22,9,12,12,9,73,70,64,75,15,18,24,13,3,0,0,3
1443,1.5,0.6428571428571429,0.9142857142857143,0.9,0.9302325581395349,3.741443038242693,5.831385212021415,7.088205741748602,3.9494537540421377,14,35,20,43,9,5,5,9,83,58,73,54,5,30,15,34,3,7,7,3
1444,1.5,0.75,0.8333333333333334,0.8148148148148148,0.8431372549019608,3.7697743202523637,5.814612316648005,7.0339763323323155,3.9497625366423605,24,36,27,51,9,9,9,9,73,61,70,46,15,27,18,42,3,3,3,3
1445,1.5,0.8695652173913043,0.8666666666666667,0.8260869565217391,0.9019607843137255,4.011906907601096,5.966477866758871,7.068365840745018,4.234364997891361,23,30,23,51,9,5,9,12,74,63,74,49,14,25,14,39,3,7,3,0
1446,1.5,0.8421052631578947,0.9130434782608695,0.9473684210526315,0.8571428571428571,3.794667563957616,5.58764327159944,7.206319401134743,3.9798412945022497,19,23,19,28,9,9,9,9,78,74,78,69,10,14,10,19,3,3,3,3
1447,1.5,0.8888888888888888,1.0,0.6666666666666666,0.8888888888888888,3.7189359161814033,5.527796461093675,6.389152804283772,3.940434865433839,9,24,9,63,9,9,9,9,88,73,88,34,0,15,0,54,3,3,3,3
1448,1.5,1.0,1.0,0.8,0.9090909090909091,3.659053407468053,5.083091956851626,6.2464787213479145,4.148312945959671,5,10,5,22,5,5,5,9,88,83,88,75,0,5,0,13,7,7,7,3
1449,1.5,0.8947368421052632,0.9285714285714286,0.8888888888888888,0.875,3.7872300592444885,5.411392883622637,6.230555703736668,3.995000132893828,19,28,9,24,9,9,9,9,78,69,88,73,10,19,0,15,3,3,3,3
1450,1.5,0.9259259259259259,0.7857142857142857,0.9655172413793104,0.9428571428571428,3.776483650061524,5.35351679271457,8.11530120288516,3.863411313442821,27,14,29,35,9,9,9,12,70,83,68,65,18,5,20,23,3,3,3,0
1451,1.5,0.85,0.8823529411764706,0.8333333333333334,0.8913043478260869,3.8314081972812843,5.42588961877543,7.215730246917135,3.929545725706867,20,17,24,46,12,9,12,12,80,80,76,54,8,8,12,34,0,3,0,0
1452,1.5,0.7931034482758621,0.8448275862068966,0.9318181818181818,0.9038461538461539,3.753818455359697,5.963200864133921,7.213962099358316,3.8386884602004097,29,58,44,52,9,12,9,9,68,42,53,45,20,46,35,43,3,0,3,3
1453,1.5,0.7142857142857143,0.95,0.9285714285714286,0.8333333333333334,3.6251041861570235,5.349589751439747,6.729215547228135,3.7384652867618056,14,20,14,18,9,5,9,9,83,73,83,79,5,15,5,9,3,7,3,3
1454,1.5,0.8461538461538461,0.875,0.9285714285714286,0.8148148148148148,3.6433897357171583,5.397584425060633,7.2392937697899375,3.919896523666326,13,16,14,27,9,9,9,12,84,81,83,73,4,7,5,15,3,3,3,0
1455,1.5,0.7333333333333333,0.7894736842105263,0.7777777777777778,0.8378378378378378,3.622820977698711,5.2822101866829705,6.735929620223271,3.8636665386633817,15,19,18,37,5,5,5,12,78,74,75,63,10,14,13,25,7,7,7,0
1456,1.5,1.0,0.9285714285714286,0.7777777777777778,1.0,3.8994554322489967,6.093464802418621,7.000367041019084,4.378406578561906,9,28,9,30,9,8,5,9,88,68,84,67,0,20,4,21,3,4,7,3
1457,1.5,0.7777777777777778,0.9375,0.8666666666666667,0.8157894736842105,3.571119344357557,4.912441161346942,6.620504072404888,3.8230957255323177,27,16,30,38,12,12,12,12,73,84,70,62,15,4,18,26,0,0,0,0
1458,1.5,0.875,0.8974358974358975,0.8571428571428571,0.9411764705882353,3.4663563660484513,5.577514310528953,6.117461334501191,3.4780271156136044,24,39,28,34,9,9,9,9,73,58,69,63,15,30,19,25,3,3,3,3
1459,1.5,0.8571428571428571,0.8653846153846154,0.9411764705882353,0.868421052631579,3.604058584715526,5.852642491391338,6.880211029222692,3.9149733910111046,21,52,17,38,12,12,8,9,79,48,79,59,9,40,9,29,0,0,4,3
1460,1.5,0.8571428571428571,0.8529411764705882,1.0,0.868421052631579,3.469340442736669,5.231824856300826,6.975400097835283,3.595938358080153,14,34,9,38,9,9,9,9,83,63,88,59,5,25,0,29,3,3,3,3
1461,1.5,0.7333333333333333,0.8947368421052632,1.0,0.9411764705882353,3.6911854735084626,5.257254189968162,6.878973747838621,4.058277752348937,15,19,11,34,5,12,5,8,78,81,82,62,10,7,6,26,7,0,7,4
1462,1.5,0.9166666666666666,0.9090909090909091,0.8888888888888888,0.8823529411764706,3.806566205205424,6.063606577892371,7.230698056034161,3.9216078132114425,12,22,9,17,9,9,9,9,85,75,88,80,3,13,0,8,3,3,3,3
1463,1.5,0.8846153846153846,0.972972972972973,0.9523809523809523,0.9130434782608695,3.676880395412449,5.5246355601935955,6.3621535994090115,3.8928571824383296,26,37,21,46,5,9,5,5,67,60,72,47,21,28,16,41,7,3,7,7
1464,1.5,0.9411764705882353,0.6666666666666666,0.8571428571428571,0.9166666666666666,3.812946463870228,5.325254910267256,7.857565160658317,4.092264798396267,17,12,28,24,12,9,12,9,83,85,72,73,5,3,16,15,0,3,0,3
1465,1.5,0.9166666666666666,0.8,0.8518518518518519,0.9393939393939394,3.779962766128819,5.370252042532366,6.846898550246444,4.046382497213679,12,5,27,33,12,5,9,9,88,88,70,64,0,0,18,24,0,7,3,3
1466,1.5,0.8333333333333334,1.0,1.0,0.9130434782608695,3.647714979434245,5.419365051600421,7.326173442593995,3.9679988175597685,12,14,22,23,12,9,12,9,88,83,78,74,0,5,10,14,0,3,0,3
1467,1.5,0.8928571428571429,0.9090909090909091,1.0,0.9615384615384616,4.006487953725697,6.0507206023403475,7.106253135020263,4.213769646639769,28,22,10,26,12,12,5,5,72,78,83,67,16,10,5,21,0,0,7,7
1468,1.5,0.8461538461538461,0.9629629629629629,0.9,0.967741935483871,3.6645188639229826,5.504657151716412,6.579925689996368,3.9138858066458484,13,27,20,31,9,5,5,9,84,66,73,66,4,22,15,22,3,7,7,3
1469,1.5,0.8,0.8333333333333334,0.8,0.9166666666666666,3.9036345874490372,5.737764364665936,6.851483279945566,4.40286480859796,5,12,5,12,5,8,5,8,88,84,88,84,0,4,0,4,7,4,7,4
1470,1.5,0.8235294117647058,0.7857142857142857,1.0,0.9310344827586207,3.7706867050348376,5.190760843743464,6.787649556103954,3.976376886348174,17,14,9,29,9,9,9,9,80,83,88,68,8,5,0,20,3,3,3,3
1471,1.5,0.8181818181818182,1.0,0.8461538461538461,0.8888888888888888,3.8788725648045683,5.54799672353282,7.238426838781047,4.002919649880492,22,21,13,27,9,9,9,9,75,76,84,70,13,12,4,18,3,3,3,3
1472,1.5,0.9,0.9285714285714286,1.0,0.88,3.6887347089533775,5.844374081435624,6.820604785590822,3.8923215809905174,10,28,5,25,5,9,5,5,83,69,88,68,5,19,0,20,7,3,7,7
1473,1.5,0.9,0.92,0.9,0.9375,3.760536796604671,5.3311480402376255,6.784604990926148,3.9102729210994474,10,25,10,32,5,12,5,9,83,75,83,65,5,13,5,23,7,0,7,3
1474,1.5,0.7777777777777778,0.9230769230769231,0.7777777777777778,0.9444444444444444,3.486420502549581,4.951400239047091,5.863445202011804,3.7312743720373214,9,13,9,36,9,9,9,12,88,84,88,64,0,4,0,24,3,3,3,0
1475,1.5,0.8461538461538461,0.918918918918919,0.8,0.8666666666666667,3.8201546967989213,6.150266756866365,6.424171246255304,4.150316285325527,13,37,20,30,9,9,12,12,84,60,80,70,4,28,8,18,3,3,0,0
1476,1.5,1.0,0.9583333333333334,0.9545454545454546,0.9166666666666666,3.528653608494272,5.351764039158247,6.856562504285674,3.929280657816303,9,24,22,48,9,9,12,9,88,73,78,49,0,15,10,39,3,3,0,3
1477,1.5,0.7619047619047619,0.9032258064516129,1.0,0.8536585365853658,3.5873857066858315,5.570062217119031,7.310402508618622,4.050282750136459,21,31,19,41,9,9,9,12,76,66,78,59,12,22,10,29,3,3,3,0
1478,1.5,0.9411764705882353,0.9629629629629629,0.9411764705882353,0.9696969696969697,3.458777707965848,5.305297560488295,5.633303989870957,3.7175233997270007,17,27,17,33,9,12,9,12,80,73,80,67,8,15,8,21,3,0,3,0
1479,1.5,0.5882352941176471,0.9705882352941176,0.7083333333333334,0.84,3.9265113963434675,6.24146983890078,7.444341282712294,4.157496988390772,17,34,24,25,9,9,12,12,80,63,76,75,8,25,12,13,3,3,0,0
1480,1.5,0.9166666666666666,0.9166666666666666,0.9473684210526315,1.0,3.558266544573067,5.127092056821848,7.103438333503857,3.7674109225593866,12,24,19,27,9,12,5,9,85,76,74,70,3,12,14,18,3,0,7,3
1481,1.5,0.75,0.9090909090909091,1.0,0.9473684210526315,3.7969741323753343,6.101000444753686,7.00642804639071,4.100058516422892,12,44,12,19,9,9,12,9,85,53,88,78,3,35,0,10,3,3,0,3
1482,1.5,0.8421052631578947,0.9166666666666666,0.8695652173913043,0.9090909090909091,3.494314586774938,5.01355605543555,6.38831297145732,3.6382880285218038,19,24,23,22,9,5,9,12,78,69,74,78,10,19,14,10,3,7,3,0
1483,1.5,0.7894736842105263,0.8148148148148148,0.8947368421052632,0.8648648648648649,3.7656149028371178,5.522187563050101,6.66055529387458,3.9090186411015155,19,27,19,37,9,9,9,9,78,70,78,60,10,18,10,28,3,3,3,3
1484,1.5,0.6923076923076923,0.7692307692307693,0.7222222222222222,0.8461538461538461,3.6439232569261524,5.182375346538899,6.451481882179675,3.9076734143878418,13,13,18,13,9,9,9,9,84,84,79,84,4,4,9,4,3,3,3,3
1485,1.5,0.8823529411764706,0.9130434782608695,0.9629629629629629,0.8928571428571429,3.753989610982565,5.978327824603197,7.8240158437876195,3.7517013754699,17,23,27,28,9,9,9,9,80,74,70,69,8,14,18,19,3,3,3,3
1486,1.5,0.7692307692307693,1.0,0.8888888888888888,0.875,3.639259891677097,4.907652867444006,6.149325333936233,3.876625811622231,13,9,9,24,5,9,5,5,80,88,84,69,8,0,4,19,7,3,7,7
1487,1.5,0.9473684210526315,0.7777777777777778,0.9333333333333333,0.8444444444444444,3.6888860428901706,5.3036021128978215,7.150854248280759,3.8727877064048912,19,36,30,45,9,12,12,12,78,64,70,55,10,24,18,33,3,0,0,0
1488,1.5,0.8888888888888888,0.8636363636363636,1.0,0.9090909090909091,3.6143414565937584,5.144408424806817,7.0999680161562075,3.7818935178100372,9,22,9,22,9,9,9,12,88,75,88,78,0,13,0,10,3,3,3,0
1489,1.5,0.8421052631578947,0.9666666666666667,0.8076923076923077,0.9166666666666666,3.758783900078952,5.775553570717482,6.775942009256791,3.905203828121473,19,30,26,36,9,12,12,9,78,70,74,61,10,18,14,27,3,0,0,3
1490,1.5,0.8275862068965517,0.9259259259259259,0.7777777777777778,0.84375,3.8152426603605187,5.9223638926712905,6.501859088426679,4.082136461715699,29,27,9,32,9,9,9,9,68,70,88,65,20,18,0,23,3,3,3,3
1491,1.5,0.7586206896551724,0.8695652173913043,0.875,0.9047619047619048,3.6083539131671487,5.595549850013991,6.984855758031693,3.841175710632199,29,23,32,42,9,9,8,9,68,74,64,55,20,14,24,33,3,3,4,3
1492,1.5,0.8235294117647058,0.9333333333333333,0.7272727272727273,0.9347826086956522,3.496890982372208,5.401089358176057,6.292313083338612,3.7530905789822415,17,45,22,46,12,8,12,12,83,51,78,54,5,37,10,34,0,4,0,0
1493,1.5,0.7777777777777778,1.0,1.0,1.0,3.6156309736187557,5.246353793549431,6.50098041486225,4.001880325173266,9,8,5,13,9,5,5,9,88,85,88,84,0,3,0,4,3,7,7,3
1494,1.5,0.625,0.7647058823529411,1.0,0.9411764705882353,3.8363019915651924,5.428658038037323,7.714515060653563,4.129812609540968,16,17,22,17,9,5,9,9,81,76,75,80,7,12,13,8,3,7,3,3
1495,1.5,0.6666666666666666,0.8205128205128205,0.8787878787878788,0.8723404255319149,3.5925822044152684,5.549518860005367,6.545722184081833,3.6810676561699065,36,39,33,47,9,9,12,12,61,58,67,53,27,30,21,35,3,3,0,0
1496,1.5,0.8461538461538461,0.8928571428571429,0.90625,0.8846153846153846,3.637350683044413,5.47432765614547,6.944311598218526,3.725743896104824,26,28,32,52,12,9,12,12,74,69,68,48,14,19,20,40,0,3,0,0
1497,1.5,0.8888888888888888,0.8809523809523809,0.9583333333333334,0.9285714285714286,3.4601470843081237,5.478181362728427,6.565406682654942,3.646352521683414,9,42,24,42,9,9,9,9,88,55,73,55,0,33,15,33,3,3,3,3
1498,1.5,0.7428571428571429,0.7631578947368421,0.7941176470588235,0.8333333333333334,3.8285947222080146,5.4461333968679035,6.7927409567337,3.8303199120981404,35,38,34,36,12,12,7,9,65,62,61,61,23,26,27,27,0,0,5,3
1499,1.5,0.6923076923076923,0.9230769230769231,1.0,0.8837209302325582,3.729736708102458,5.267966480697491,7.278146646021027,4.167757562741956,13,26,24,43,9,12,9,12,84,74,73,57,4,14,15,31,3,0,3,0
