,Signal_Fac,coverage_naive,coverage_split50,coverage_split67,coverage_posi,length_naive,length_split50,length_split67,length_posi,nnz_naive,nnz_split50,nnz_split67,nnz_posi,tp_naive,tp_split50,tp_split67,tp_posi,tn_naive,tn_split50,tn_split67,tn_posi,fp_naive,fp_split50,fp_split67,fp_posi,fn_naive,fn_split50,fn_split67,fn_posi,cseed
0,0.1,0.8,0.8717948717948718,0.8947368421052632,0.9473684210526315,10.287023571235093,15.661344540992923,19.049222122017458,11.332986795319613,15,39,19,19,4,4,4,0,82,58,78,74,11,35,15,19,6,6,6,10,1986
1,0.1,0.875,0.8947368421052632,0.8,0.9117647058823529,10.26876950970621,15.624486734869203,18.32733522369227,12.024063890303305,8,38,15,34,8,8,4,4,93,63,82,63,0,30,11,30,2,2,6,6,1987
2,0.1,0.5833333333333334,0.8235294117647058,0.8421052631578947,0.8666666666666667,10.22140523968024,15.510050440270568,19.060954083340754,11.426573985732864,12,34,19,15,4,7,7,7,85,66,81,85,8,27,12,8,6,3,3,3,1988
3,0.1,0.5,0.9285714285714286,1.0,0.95,10.122815541675278,15.275250950850927,17.785724179490764,12.202843135801885,4,28,8,20,0,8,8,1,89,73,93,74,4,20,0,19,10,2,2,9,1989
4,0.1,0.7,0.9090909090909091,0.8571428571428571,0.7954545454545454,10.405701447621633,15.387353409446238,20.099087649601625,11.925769252519727,20,33,35,44,1,0,1,4,74,60,59,53,19,33,34,40,9,10,9,6,1990
5,0.1,0.75,0.8888888888888888,0.9565217391304348,0.9259259259259259,10.336333164444905,15.392113888092354,19.24196777331761,12.640930692217454,8,27,23,27,0,0,0,0,85,66,70,66,8,27,23,27,10,10,10,10,1991
6,0.1,0.625,0.9,1.0,0.9285714285714286,10.241278757762892,15.773852110701643,19.120032796238895,11.716657339054478,8,40,27,28,4,4,8,8,89,57,74,73,4,36,19,20,6,6,2,2,1992
7,0.1,0.75,0.9428571428571428,0.8717948717948718,0.9565217391304348,10.377207486990851,15.442451118436765,20.39977468880213,11.580988131089578,20,35,39,23,4,4,4,0,77,62,58,70,16,31,35,23,6,6,6,10,1993
8,0.1,0.625,0.9722222222222222,0.8125,0.9393939393939394,10.183693494303172,15.62222514462789,18.797581170563564,11.655643633089237,8,36,16,33,0,0,4,4,85,57,81,64,8,36,12,29,10,10,6,6,1994
9,0.1,0.75,0.8148148148148148,0.9583333333333334,0.9,10.19880099725882,15.416486259749323,19.087245445409746,11.941532989796368,4,27,24,30,1,5,5,1,90,71,74,64,3,22,19,29,9,5,5,9,1995
10,0.2,0.875,0.8780487804878049,0.8518518518518519,0.9375,10.303873764601779,15.618268348295869,19.51453735373454,11.423331140514744,8,41,27,16,4,10,4,8,89,62,70,85,4,31,23,8,6,0,6,2,1996
11,0.2,0.9285714285714286,0.9534883720930233,0.9130434782608695,1.0,10.392955454467181,15.884046062946876,19.114898564199585,11.556880108919794,14,43,23,23,10,10,8,7,89,60,78,77,4,33,15,16,0,0,2,3,1997
12,0.2,0.8,0.9183673469387755,0.875,0.8947368421052632,10.270553374545011,16.221127166978548,18.83017092427105,11.449028207416058,10,49,16,19,10,8,4,7,93,52,81,81,0,41,12,12,0,2,6,3,1998
13,0.2,0.782608695652174,0.875,0.9629629629629629,0.9117647058823529,10.42312849009062,15.992976233696174,19.607449092755058,11.894369597534679,23,48,27,34,8,8,8,8,78,53,74,67,15,40,19,26,2,2,2,2,1999
14,0.2,0.625,0.7631578947368421,0.7857142857142857,0.8709677419354839,10.242732187083407,15.571412124605935,19.652396162258757,11.964996587974507,8,38,28,31,0,0,4,4,85,55,69,66,8,38,24,27,10,10,6,6,2000
15,0.2,0.8181818181818182,0.92,0.9130434782608695,0.9565217391304348,10.242250380221957,15.314482999655361,19.19096895476473,11.57228904105635,11,25,23,23,7,4,7,7,89,72,77,77,4,21,16,16,3,6,3,3,2001
16,0.2,0.6666666666666666,0.8461538461538461,1.0,0.9629629629629629,10.353398620286777,15.820008941993052,19.498128438560727,11.532121365029909,15,39,30,27,7,8,7,7,85,62,70,73,8,31,23,20,3,2,3,3,2002
17,0.2,0.9090909090909091,0.8181818181818182,0.8636363636363636,0.8888888888888888,10.289794602257706,15.531861202201474,19.122694007572665,11.633318571811461,11,33,22,27,7,5,7,7,89,65,78,73,4,28,15,20,3,5,3,3,2003
18,0.2,0.7857142857142857,0.9210526315789473,0.8928571428571429,0.9428571428571428,10.489991223784221,15.63489744232289,19.343329957069294,12.205570457878533,28,38,28,35,8,4,8,10,73,59,73,68,20,34,20,25,2,6,2,0,2004
19,0.2,0.75,0.9428571428571428,1.0,0.9259259259259259,10.30706504747841,15.537143897451815,19.08014525614124,11.310611957958233,16,35,20,27,8,8,8,8,85,66,81,74,8,27,12,19,2,2,2,2,2005
20,0.3,0.6842105263157895,0.926829268292683,0.9629629629629629,0.9142857142857143,10.397335066979348,15.760108412052016,19.367998808979646,11.650038133468371,19,41,27,35,4,10,4,4,78,62,70,62,15,31,23,31,6,0,6,6,2006
21,0.3,0.6428571428571429,0.8,0.84,0.8846153846153846,10.36540681991777,15.479981096413184,18.844781799946237,11.535566952019174,14,40,25,26,10,10,10,10,89,63,78,77,4,30,15,16,0,0,0,0,2007
22,0.3,0.9090909090909091,0.8936170212765957,0.96,1.0,10.341408820742878,16.089725869803377,19.270000387793573,11.582979469293548,11,47,25,30,8,8,10,7,90,54,78,70,3,39,15,23,2,2,0,3,2008
23,0.3,0.7083333333333334,0.9767441860465116,0.9142857142857143,0.9,10.366134830359385,15.88237887750202,19.543982295382136,11.326299435685304,24,43,35,30,8,8,8,8,77,58,66,71,16,35,27,22,2,2,2,2,2009
24,0.3,0.5454545454545454,0.8809523809523809,0.8421052631578947,0.9375,10.334990241776522,15.816653255888795,19.16262528043301,12.193731650871612,11,42,19,16,7,4,7,8,89,55,81,85,4,38,12,8,3,6,3,2,2010
25,0.3,0.6875,0.8958333333333334,0.7727272727272727,0.9333333333333333,10.362776690256847,16.03039093966675,19.078656145088875,11.432407197966235,16,48,22,30,8,10,10,10,85,55,81,73,8,38,12,20,2,0,0,0,2011
26,0.3,0.875,0.9130434782608695,0.9375,0.9130434782608695,10.252656227148389,15.291672927907872,18.38216990682878,12.009150771934346,8,23,16,23,4,0,4,4,89,70,81,74,4,23,12,19,6,10,6,6,2012
27,0.3,0.782608695652174,0.8461538461538461,0.8260869565217391,0.8857142857142857,10.479207880387692,15.788265953952754,20.81136754076246,10.713355999579079,23,39,46,35,8,10,7,8,78,64,54,66,15,29,39,27,2,0,3,2,2013
28,0.3,0.8076923076923077,0.8918918918918919,0.9696969696969697,0.9333333333333333,10.386011472397996,15.577600727802073,19.682973533100355,11.26581341189501,26,37,33,30,10,7,10,10,77,63,70,73,16,30,23,20,0,3,0,0,2014
29,0.3,0.8181818181818182,0.9130434782608695,0.9714285714285714,0.967741935483871,10.355380375932462,15.300375203643124,20.139160639219067,12.23191319768902,11,23,35,31,8,8,8,10,90,78,66,72,3,15,27,21,2,2,2,0,2015
30,0.4,0.8333333333333334,0.9411764705882353,0.875,1.0,10.228502880041686,15.53673132993069,18.387396707940106,11.79555334571839,12,34,16,32,8,8,8,8,89,67,85,69,4,26,8,24,2,2,2,2,2016
31,0.4,0.875,0.8695652173913043,0.8421052631578947,0.8421052631578947,10.324676450175149,14.93493419889145,18.672273948211497,12.286932004124287,8,23,19,19,4,4,4,4,89,74,78,78,4,19,15,15,6,6,6,6,2017
32,0.4,0.9,0.9433962264150944,0.8064516129032258,0.918918918918919,10.346010442974947,16.339731821464426,19.72337573097489,11.865445853826747,10,53,31,37,10,10,7,7,93,50,69,63,0,43,24,30,0,0,3,3,2018
33,0.4,0.8333333333333334,0.9333333333333333,0.8636363636363636,0.9333333333333333,10.30491288951153,15.254635216496142,19.645775258602313,11.604905926545827,18,30,22,15,10,4,10,7,85,67,81,85,8,26,12,8,0,6,0,3,2019
34,0.4,0.7272727272727273,0.8611111111111112,0.9333333333333333,0.8666666666666667,10.336948954956476,15.635328473435882,18.45904955302893,11.910755848893974,11,36,15,30,7,7,7,10,89,64,85,73,4,29,8,20,3,3,3,0,2020
35,0.4,0.9,0.925,1.0,1.0,10.314490844175847,15.650232514898306,18.861194763658986,11.612720409847507,10,40,22,18,10,10,10,10,93,63,81,85,0,30,12,8,0,0,0,0,2021
36,0.4,0.8571428571428571,0.9655172413793104,0.9545454545454546,0.9629629629629629,10.258972707826734,15.449108292255382,19.193076195552518,11.964462430736504,7,29,22,27,7,7,10,7,93,71,81,73,0,22,12,20,3,3,0,3,2022
37,0.4,0.8125,0.9393939393939394,0.7419354838709677,0.8518518518518519,10.387567578109529,15.608337505650708,19.7361788256273,11.682401997340364,16,33,31,27,4,4,0,8,81,64,62,74,12,29,31,19,6,6,10,2,2023
38,0.4,0.7272727272727273,0.8928571428571429,0.9615384615384616,0.8604651162790697,10.43497339149855,15.245089156569124,19.475249373984308,11.905872172153044,22,28,26,43,10,10,8,10,81,75,75,60,12,18,18,33,0,0,2,0,2024
39,0.4,0.9,0.9777777777777777,0.9615384615384616,0.8888888888888888,10.419102242512816,15.853774602879652,19.417391703028038,12.64623365073145,20,45,26,45,10,8,7,8,83,56,74,56,10,37,19,37,0,2,3,2,2025
40,0.5,0.7142857142857143,0.896551724137931,0.8620689655172413,0.8636363636363636,10.317691485387131,15.37328873609512,19.693185430302652,11.39372948580521,14,29,29,22,10,10,10,10,89,74,74,81,4,19,19,12,0,0,0,0,2026
41,0.5,0.875,0.8928571428571429,0.8571428571428571,0.9393939393939394,10.295753555422504,15.319242207942539,18.747852800276053,12.880173589582636,8,28,14,33,4,10,4,7,89,75,83,67,4,18,10,26,6,0,6,3,2027
42,0.5,0.8333333333333334,0.9318181818181818,0.96,0.8571428571428571,10.35979670091035,16.072089735449378,19.467030711489517,11.411900086773983,12,44,25,14,4,10,10,10,85,59,78,89,8,34,15,4,6,0,0,0,2028
43,0.5,0.6666666666666666,0.8787878787878788,0.9393939393939394,0.9,10.262037817843686,15.40458512997351,20.008423160800284,10.69947677638722,12,33,33,20,8,10,8,8,89,70,68,81,4,23,25,12,2,0,2,2,2029
44,0.5,0.9333333333333333,0.9122807017543859,1.0,0.8148148148148148,10.335789469067095,16.319480218947486,19.454979877200728,12.0434305522538,15,57,26,27,7,7,10,7,85,43,77,73,8,50,16,20,3,3,0,3,2030
45,0.5,1.0,0.9487179487179487,0.9666666666666667,0.92,10.347928826448717,15.925148717795732,19.91829810006144,12.042701405281951,10,39,30,25,10,10,10,10,93,64,73,78,0,29,20,15,0,0,0,0,2031
46,0.5,0.9411764705882353,0.85,0.8333333333333334,0.972972972972973,10.398215113484493,15.664025095321918,19.476311491263274,12.433294611319651,17,40,30,37,10,4,10,10,86,57,73,66,7,36,20,27,0,6,0,0,2032
47,0.5,0.8181818181818182,0.9230769230769231,0.8285714285714286,0.9354838709677419,10.241906869161893,16.21566054643112,20.13588797142537,11.52134569611766,11,52,35,31,7,10,7,7,89,51,65,69,4,42,28,24,3,0,3,3,2033
48,0.5,0.7272727272727273,0.925,0.8846153846153846,0.8846153846153846,10.302121989076753,15.825653657774978,19.426480107027935,12.164690529879522,11,40,26,26,7,7,7,7,89,60,74,74,4,33,19,19,3,3,3,3,2034
49,0.5,0.9,0.9166666666666666,1.0,0.9459459459459459,10.306614733112331,15.146813296673622,19.197664862059455,12.134571214343502,10,24,29,37,10,8,10,10,93,77,74,66,0,16,19,27,0,2,0,0,2035
50,0.6,0.9090909090909091,0.8,0.7894736842105263,0.9615384615384616,10.336449472665047,15.395105926162481,19.0584461301255,12.528032709668876,11,30,19,26,7,7,7,7,89,70,81,74,4,23,12,19,3,3,3,3,2036
51,0.6,0.7777777777777778,0.9230769230769231,0.8571428571428571,0.8260869565217391,10.358262407961558,15.615363635009558,20.39945444350829,11.348225915037245,18,39,42,23,10,8,10,8,85,62,61,78,8,31,32,15,0,2,0,2,2037
52,0.6,0.8571428571428571,1.0,1.0,0.9523809523809523,10.405791914141071,15.100138109073159,19.427560696078064,11.126649668641202,14,22,32,21,10,10,10,10,89,81,71,82,4,12,22,11,0,0,0,0,2038
53,0.6,0.8888888888888888,0.9310344827586207,0.96,1.0,10.386746094327894,15.404188076730527,18.927241586698372,11.11193280703868,18,29,25,17,10,10,10,10,85,74,78,86,8,19,15,7,0,0,0,0,2039
54,0.6,0.8,0.8947368421052632,0.868421052631579,0.92,10.511146852007675,15.604763463115606,20.03914393400033,11.113977594925336,20,38,38,25,10,10,8,10,83,65,63,78,10,28,30,15,0,0,2,0,2040
55,0.6,1.0,1.0,0.9655172413793104,1.0,10.347978424541356,15.713132796306551,19.53112603498286,11.057269996027959,10,37,29,16,10,10,10,8,93,66,74,85,0,27,19,8,0,0,0,2,2041
56,0.6,0.875,0.9130434782608695,1.0,0.9166666666666666,10.235851079275669,15.972892901190027,19.040348100032993,11.517252387714777,8,46,19,24,8,8,8,8,93,55,82,77,0,38,11,16,2,2,2,2,2042
57,0.6,0.6428571428571429,0.8823529411764706,0.9090909090909091,0.84375,10.344895967944728,16.248394745757242,19.44319015494694,12.539393949250174,14,51,33,32,10,10,10,10,89,52,70,71,4,41,23,22,0,0,0,0,2043
58,0.6,0.8571428571428571,0.9333333333333333,0.9230769230769231,0.8518518518518519,10.325443133324653,15.398071626559732,18.994228561381277,11.652941359425776,14,30,26,27,10,10,10,7,89,73,77,73,4,20,16,20,0,0,0,3,2044
59,0.6,0.9285714285714286,0.896551724137931,0.8181818181818182,1.0,10.315157331470933,15.280075193977988,19.204756882487104,11.61602688757739,14,29,22,26,10,10,10,10,89,74,81,77,4,19,12,16,0,0,0,0,2045
60,0.7,0.75,0.8,0.9411764705882353,0.875,10.318205397519456,15.26975083933113,19.895466969373103,10.955346395278708,16,30,34,16,8,8,8,8,85,71,67,85,8,22,26,8,2,2,2,2,2046
61,0.7,0.9285714285714286,0.9074074074074074,0.8857142857142857,0.8620689655172413,10.329108601949004,16.37631692914081,20.123096379249898,11.650351644967888,14,54,35,29,10,10,10,10,89,49,68,74,4,44,25,19,0,0,0,0,2047
62,0.7,0.875,0.8285714285714286,0.9259259259259259,0.9230769230769231,10.316936317266697,15.534306932117147,19.12606964531155,11.754351969536181,16,35,27,26,8,8,8,10,85,66,74,77,8,27,19,16,2,2,2,0,2048
63,0.7,0.9285714285714286,0.868421052631579,0.9615384615384616,0.9230769230769231,10.482609287937986,15.673228150242336,19.493460354198195,10.955636683905261,14,38,26,26,10,10,10,10,89,65,77,77,4,28,16,16,0,0,0,0,2049
64,0.7,0.7307692307692307,0.8421052631578947,0.88,0.9047619047619048,10.484355627470164,15.734969212576521,21.175328651653057,11.424437445875034,26,38,50,42,10,10,10,10,77,65,53,61,16,28,40,32,0,0,0,0,2050
65,0.7,0.9,0.9375,1.0,0.92,10.311087864762877,15.417003659917329,19.050010557209806,11.472301471666556,10,32,18,25,10,10,10,10,93,71,85,78,0,22,8,15,0,0,0,0,2051
66,0.7,0.5909090909090909,0.92,0.8157894736842105,0.8529411764705882,10.34462973170806,16.268229635456706,20.098414810922453,12.111345181374851,22,50,38,34,10,10,10,10,81,53,65,69,12,40,28,24,0,0,0,0,2052
67,0.7,0.8571428571428571,1.0,0.9655172413793104,0.8484848484848485,10.289827452206788,15.228921211147984,19.450144863889996,11.843065908184405,14,26,29,33,10,10,10,10,89,77,74,70,4,16,19,23,0,0,0,0,2053
68,0.7,0.7857142857142857,0.94,0.9545454545454546,1.0,10.370923046914116,16.17545581541601,19.12846629182511,11.554311061044944,14,50,22,27,10,7,10,7,89,50,81,73,4,43,12,20,0,3,0,3,2054
69,0.7,0.8571428571428571,0.8947368421052632,1.0,0.9722222222222222,10.414434817134829,16.476035576011324,20.127578012871087,11.71467160210632,14,57,37,36,7,10,7,10,86,46,63,67,7,47,30,26,3,0,3,0,2055
70,0.7999999999999999,0.7857142857142857,0.8958333333333334,0.8947368421052632,0.9259259259259259,10.296085907048292,15.997020308625565,19.05462056341055,11.882548221491835,14,48,19,27,10,7,7,8,89,52,81,74,4,41,12,19,0,3,3,2,2056
71,0.7999999999999999,0.8823529411764706,0.9459459459459459,0.9230769230769231,0.9032258064516129,10.435989181076362,15.686256157972952,20.64955391327532,11.982976204777895,17,37,39,31,10,10,10,10,86,66,64,72,7,27,29,21,0,0,0,0,2057
72,0.7999999999999999,0.8181818181818182,0.7727272727272727,0.9545454545454546,0.9,10.29987900729141,15.035118222154159,19.00800123824917,11.770548028427916,11,22,22,30,7,10,10,10,89,81,81,73,4,12,12,20,3,0,0,0,2058
73,0.7999999999999999,1.0,0.9230769230769231,0.8888888888888888,1.0,10.252349615781522,15.291572304367433,18.560550164410557,11.22245531157327,10,26,18,18,10,10,10,10,93,77,85,85,0,16,8,8,0,0,0,0,2059
74,0.7999999999999999,0.7857142857142857,0.90625,0.9230769230769231,0.96,10.281974719643355,15.39314141866661,19.755014088758625,11.421782172341382,14,32,26,25,10,10,10,10,89,71,77,78,4,22,16,15,0,0,0,0,2060
75,0.7999999999999999,0.9285714285714286,0.8717948717948718,0.7804878048780488,0.92,10.319729250526652,15.777467521537229,20.599167348301293,11.732913739869694,14,39,41,25,10,10,10,10,89,64,62,78,4,29,31,15,0,0,0,0,2061
76,0.7999999999999999,0.75,1.0,0.7647058823529411,0.85,10.307521794303524,15.433853052665809,18.502335000662416,10.788803030315531,12,34,17,20,8,10,10,8,89,69,86,81,4,24,7,12,2,0,0,2,2062
77,0.7999999999999999,0.7857142857142857,0.9302325581395349,0.9,0.868421052631579,10.353369638159917,15.826509874545462,19.81635503429614,11.717007658619034,14,43,30,38,10,10,10,10,89,60,73,65,4,33,20,28,0,0,0,0,2063
78,0.7999999999999999,0.6666666666666666,0.8846153846153846,0.76,0.8620689655172413,10.348901237202005,15.175182374268758,19.196883711923544,11.295044304909446,18,26,25,29,10,10,10,10,85,77,78,74,8,16,15,19,0,0,0,0,2064
79,0.7999999999999999,0.8461538461538461,0.9333333333333333,0.9166666666666666,0.875,10.300842971601005,15.91583244814351,19.015607387007012,11.344189592005312,13,45,24,24,10,10,10,10,90,58,79,79,3,35,14,14,0,0,0,0,2065
80,0.8999999999999999,0.85,1.0,0.96,0.9545454545454546,10.366047230260333,15.73131790416556,19.293555938481465,11.246078987543351,20,40,25,22,10,8,10,10,83,61,78,81,10,32,15,12,0,2,0,0,2066
81,0.8999999999999999,0.88,0.896551724137931,0.9487179487179487,0.9473684210526315,10.495567671046121,15.229564152914728,20.3377930800243,11.6197123959513,25,29,39,38,10,8,10,10,78,72,64,65,15,21,29,28,0,2,0,0,2067
82,0.8999999999999999,0.7692307692307693,0.868421052631579,0.9512195121951219,0.8666666666666667,10.488486870480749,15.537242029105318,20.230975893720743,11.714364819978988,26,38,41,45,10,10,10,7,77,65,62,55,16,28,31,38,0,0,0,3,2068
83,0.8999999999999999,0.7333333333333333,0.8648648648648649,0.9333333333333333,0.896551724137931,10.33220594806395,15.637443925370954,19.303907136607084,11.817804542632418,15,37,30,29,7,10,7,7,85,66,70,71,8,27,23,22,3,0,3,3,2069
84,0.8999999999999999,0.9,0.8717948717948718,0.96,1.0,10.321083337206757,15.736076431421417,19.444834053462603,11.702536951067497,10,39,25,20,10,10,10,8,93,64,78,81,0,29,15,12,0,0,0,2,2070
85,0.8999999999999999,0.7857142857142857,0.8666666666666667,0.9545454545454546,0.8518518518518519,10.33042056627412,15.393363483894808,19.005610789221393,11.70086962908177,14,30,22,27,10,10,7,8,89,73,78,74,4,20,15,19,0,0,3,2,2071
86,0.8999999999999999,0.7142857142857143,0.8666666666666667,0.9090909090909091,0.9166666666666666,10.388881662566863,15.381091378154554,19.048975676063808,11.687596778144048,14,30,22,36,10,10,10,10,89,73,81,67,4,20,12,26,0,0,0,0,2072
87,0.8999999999999999,0.6666666666666666,0.9090909090909091,0.8571428571428571,0.9090909090909091,10.450105299333464,15.617619317537304,19.060848018730493,11.070344037502995,21,33,21,22,10,10,10,10,82,70,82,81,11,23,11,12,0,0,0,0,2073
88,0.8999999999999999,0.8571428571428571,0.9393939393939394,0.9230769230769231,0.8846153846153846,10.431730164279326,15.576801767105952,19.1939599028734,11.253778256234094,14,33,26,26,10,10,10,10,89,70,77,77,4,23,16,16,0,0,0,0,2074
89,0.8999999999999999,0.7727272727272727,0.8888888888888888,0.8928571428571429,0.9333333333333333,10.45711777146244,16.406056536172795,19.69132991794397,11.03828775347011,22,54,28,30,10,10,10,10,81,49,75,73,12,44,18,20,0,0,0,0,2075
90,0.9999999999999999,0.7857142857142857,0.90625,0.896551724137931,0.896551724137931,10.338994171533107,15.386559966256813,19.512538443764477,11.989736117029013,14,32,29,29,10,10,10,10,89,71,74,74,4,22,19,19,0,0,0,0,2076
91,0.9999999999999999,0.7727272727272727,0.88,0.9411764705882353,1.0,10.478170549823353,16.01846961033613,18.622983638823044,11.27742400363686,22,50,17,26,10,10,10,10,81,53,86,77,12,40,7,16,0,0,0,0,2077
92,0.9999999999999999,0.8235294117647058,0.9310344827586207,0.8461538461538461,0.9545454545454546,10.394151677069889,16.479164404780057,19.098026746553373,11.407658291771778,17,58,26,22,10,10,8,10,86,45,75,81,7,48,18,12,0,0,2,0,2078
93,0.9999999999999999,0.92,0.9090909090909091,0.972972972972973,1.0,10.554784005182274,15.394707121111752,20.621380763309,11.18832923308706,25,33,37,25,10,10,10,10,78,70,66,78,15,23,27,15,0,0,0,0,2079
94,0.9999999999999999,0.9285714285714286,0.9534883720930233,0.918918918918919,1.0,10.35576033351513,15.919627148988253,20.249253395796487,11.87878506273726,14,43,37,37,10,10,10,10,89,60,66,66,4,33,27,27,0,0,0,0,2080
95,0.9999999999999999,0.7857142857142857,0.9523809523809523,0.88,0.8846153846153846,10.364765124115065,15.899576916977058,19.432950221523416,10.56698228673295,14,42,25,26,10,10,10,10,89,61,78,77,4,32,15,16,0,0,0,0,2081
96,0.9999999999999999,1.0,0.8809523809523809,1.0,0.9411764705882353,10.383257636048734,15.655341224847442,18.310815992803548,11.361809025130494,10,42,10,34,10,10,10,10,93,61,93,69,0,32,0,24,0,0,0,0,2082
97,0.9999999999999999,0.7142857142857143,0.925,0.8928571428571429,0.9666666666666667,10.384608814155639,15.682813075417382,19.39207348262047,11.467490771606647,14,40,28,30,10,10,10,10,89,63,75,73,4,30,18,20,0,0,0,0,2083
98,0.9999999999999999,0.8181818181818182,0.9,0.8636363636363636,0.9032258064516129,10.43322272742587,15.462853702595346,19.10569218405225,11.258807511593224,22,30,22,31,10,10,10,8,81,73,81,70,12,20,12,23,0,0,0,2,2084
99,0.9999999999999999,0.6111111111111112,0.7692307692307693,0.8666666666666667,0.896551724137931,10.42648109916913,15.69629190907014,19.69520045078126,11.562960493119627,18,39,30,29,10,10,10,10,85,64,73,74,8,29,20,19,0,0,0,0,2085
100,1.0999999999999999,0.8,0.9333333333333333,0.92,0.9487179487179487,10.491980636864964,16.694210330609224,19.603666661584736,11.556957748311191,25,60,25,39,10,10,10,10,78,43,78,64,15,50,15,29,0,0,0,0,2086
101,1.0999999999999999,0.8235294117647058,0.9722222222222222,0.8787878787878788,0.9375,10.41705663284512,15.524425358246296,19.995019028759106,11.295343707781681,17,36,33,32,10,10,10,10,86,67,70,71,7,26,23,22,0,0,0,0,2087
102,1.0999999999999999,1.0,0.9714285714285714,0.8648648648648649,0.9615384615384616,10.365313913446714,15.481906027650117,20.22745335672449,11.950608068349052,10,35,37,26,10,10,10,10,93,68,66,77,0,25,27,16,0,0,0,0,2088
103,1.0999999999999999,0.6363636363636364,0.8285714285714286,1.0,0.8125,10.413823979157797,15.476939390993916,18.90988558084571,11.232257557686818,22,35,22,32,10,10,10,10,81,68,81,71,12,25,12,22,0,0,0,0,2089
104,1.0999999999999999,0.7727272727272727,0.9069767441860465,0.875,0.8484848484848485,10.453477430993663,15.869295002381108,19.749561172910937,11.613827258244534,22,43,32,33,10,10,10,10,81,60,71,70,12,33,22,23,0,0,0,0,2090
105,1.0999999999999999,0.7777777777777778,0.8571428571428571,0.9032258064516129,0.8823529411764706,10.424987028630078,15.645298081922546,19.798507781680666,11.219067133289977,18,35,31,17,10,10,10,10,85,68,72,86,8,25,21,7,0,0,0,0,2091
106,1.0999999999999999,0.7,0.95,0.7857142857142857,0.9411764705882353,10.384996751472958,15.74947232105519,18.344472286283853,11.689459635882985,10,40,14,34,10,10,10,10,93,63,89,69,0,30,4,24,0,0,0,0,2092
107,1.0999999999999999,0.8461538461538461,0.96,0.9696969696969697,0.8888888888888888,10.315767363707323,16.037944370606787,19.707803079512487,10.901891300199726,13,50,33,18,10,10,10,10,90,53,70,85,3,40,23,8,0,0,0,0,2093
108,1.0999999999999999,0.8571428571428571,0.8205128205128205,0.8947368421052632,0.9375,10.306855316752959,15.636526999973626,19.859121354695915,11.377991550343175,14,39,38,32,10,8,8,10,89,62,63,71,4,31,30,22,0,2,2,0,2094
109,1.0999999999999999,0.7647058823529411,0.8604651162790697,0.8780487804878049,0.9375,10.310872176196618,15.794165367216758,20.747835259544058,11.794919029094125,17,43,41,32,10,10,10,10,86,60,62,71,7,33,31,22,0,0,0,0,2095
110,1.2,0.8571428571428571,0.9024390243902439,0.8181818181818182,0.9285714285714286,10.259528121816656,15.824918832514157,19.458097032731867,10.851312070759219,14,41,22,14,10,10,10,10,89,62,81,89,4,31,12,4,0,0,0,0,2096
111,1.2,0.7222222222222222,0.8333333333333334,0.8333333333333334,0.8,10.357550871342148,15.817531867306451,19.509491263265463,11.702620992470626,18,42,30,30,10,10,10,10,85,61,73,73,8,32,20,20,0,0,0,0,2097
112,1.2,0.9285714285714286,0.975609756097561,0.8181818181818182,0.9565217391304348,10.261855505941961,15.656475330248385,19.34552114371072,11.759634077846291,14,41,22,46,10,10,10,10,89,62,81,57,4,31,12,36,0,0,0,0,2098
113,1.2,0.7222222222222222,0.8863636363636364,0.9,0.9333333333333333,10.347915318131129,15.980522631496676,19.640643829580657,11.201452389111376,18,44,30,30,10,10,10,10,85,59,73,73,8,34,20,20,0,0,0,0,2099
114,1.2,1.0,1.0,1.0,1.0,10.373283677130647,15.510991360777618,19.048674954131457,11.793085804476538,10,35,22,17,10,10,10,10,93,68,81,86,0,25,12,7,0,0,0,0,2100
115,1.2,0.7142857142857143,0.7647058823529411,0.8636363636363636,0.8421052631578947,10.42857093208126,15.574056078083325,19.386139134051504,12.217467277423244,14,34,22,38,10,7,10,10,89,66,81,65,4,27,12,28,0,3,0,0,2101
116,1.2,0.8,0.8235294117647058,0.9130434782608695,0.9375,10.323032968767698,15.70178083133906,19.473178546311544,11.930326526091072,15,34,23,32,7,7,7,10,85,66,77,71,8,27,16,22,3,3,3,0,2102
117,1.2,0.8571428571428571,0.9285714285714286,0.896551724137931,0.9666666666666667,10.322080312298537,15.85026767795492,19.632892824025276,10.964438044870395,14,42,29,30,10,10,10,10,89,61,74,73,4,32,19,20,0,0,0,0,2103
118,1.2,0.9,0.8974358974358975,0.9666666666666667,0.8780487804878049,10.352972940680148,15.854162822763938,19.784239711738703,11.803274800810657,10,39,30,41,10,10,10,10,93,64,73,62,0,29,20,31,0,0,0,0,2104
119,1.2,0.8,0.9,0.8333333333333334,0.9705882352941176,10.3651057579913,15.324285143957258,18.967145771852913,11.641963298327793,10,30,18,34,10,10,10,10,93,73,85,69,0,20,8,24,0,0,0,0,2105
120,1.3,0.8461538461538461,0.8372093023255814,0.90625,0.9459459459459459,10.455670808269424,15.78588594857277,19.799385505363023,11.237779622723133,26,43,32,37,10,10,10,10,77,60,71,66,16,33,22,27,0,0,0,0,2106
121,1.3,0.7692307692307693,0.7884615384615384,0.9069767441860465,0.868421052631579,10.489469725498306,16.33639909818763,20.628359663326265,11.421538727902071,26,52,43,38,10,10,10,10,77,51,60,65,16,42,33,28,0,0,0,0,2107
122,1.3,0.7142857142857143,0.9722222222222222,1.0,0.92,10.374764041864196,15.84204844590533,19.212632147477784,11.211697014698432,14,36,22,25,10,10,10,10,89,67,81,78,4,26,12,15,0,0,0,0,2108
123,1.3,0.8823529411764706,0.8484848484848485,0.9615384615384616,0.9545454545454546,10.400244195154242,15.53303955088267,19.208686579699904,11.598740529628913,17,33,26,22,10,10,10,10,86,70,77,81,7,23,16,12,0,0,0,0,2109
124,1.3,0.8571428571428571,0.96,0.9512195121951219,0.9285714285714286,10.42745406524892,16.23267347583591,20.413211493723143,11.108066735143948,21,50,41,28,10,10,10,10,82,53,62,75,11,40,31,18,0,0,0,0,2110
125,1.3,0.7727272727272727,0.9210526315789473,0.9459459459459459,0.8484848484848485,10.37083513867759,15.63803193511512,20.158441141802257,11.415279489711523,22,38,37,33,10,10,10,10,81,65,66,70,12,28,27,23,0,0,0,0,2111
126,1.3,0.8571428571428571,0.825,0.9166666666666666,0.8846153846153846,10.41840483697007,15.983523397182784,20.594075966038638,11.635084292666429,14,40,36,26,10,10,10,10,89,63,67,77,4,30,26,16,0,0,0,0,2112
127,1.3,0.9,0.967741935483871,0.9166666666666666,0.9210526315789473,10.319363383186866,15.6852590031907,19.290763800013895,12.143243967963054,10,31,24,38,10,8,8,8,93,70,77,63,0,23,16,30,0,2,2,2,2113
128,1.3,0.8333333333333334,0.8723404255319149,0.8666666666666667,0.9166666666666666,10.369893883210041,15.910864307507603,19.304873218369075,11.604682737936415,18,47,30,36,10,10,10,10,85,56,73,67,8,37,20,26,0,0,0,0,2114
129,1.3,0.875,0.8620689655172413,0.7916666666666666,0.8518518518518519,10.29078403027989,15.252713267641537,19.324944864096235,11.796598395058261,8,29,24,27,8,10,8,8,93,74,77,74,0,19,16,19,2,0,2,2,2115
130,1.4,0.8888888888888888,0.90625,0.8333333333333334,0.8846153846153846,10.423404134521203,15.518484832656519,19.524671787308986,11.204622401745656,18,32,30,26,10,10,10,10,85,71,73,77,8,22,20,16,0,0,0,0,2116
131,1.4,0.8571428571428571,0.8863636363636364,0.92,0.9545454545454546,10.315417487935992,15.938136132030776,19.137801375853112,11.187786049963101,14,44,25,22,10,10,10,10,89,59,78,81,4,34,15,12,0,0,0,0,2117
132,1.4,0.7058823529411765,0.8928571428571429,1.0,0.8387096774193549,10.431198419989556,15.273042846343346,19.750418850373983,11.106398686920784,17,28,32,31,10,10,10,8,86,75,71,70,7,18,22,23,0,0,0,2,2118
133,1.4,0.8571428571428571,0.9302325581395349,0.9428571428571428,0.8529411764705882,10.46052783967589,16.163046487638447,20.450408471744744,11.305082326006001,14,43,35,34,10,8,10,10,89,58,68,69,4,35,25,24,0,2,0,0,2119
134,1.4,0.9285714285714286,0.85,0.8918918918918919,0.9523809523809523,10.308834837279562,15.725359843005197,20.097494858083607,11.068799241045816,14,40,37,21,10,10,10,10,89,63,66,82,4,30,27,11,0,0,0,0,2120
135,1.4,0.9047619047619048,0.9166666666666666,0.92,0.9310344827586207,10.406672083824697,15.475705285701228,19.073821245607864,11.950976751790831,21,36,25,29,10,10,10,10,82,67,78,74,11,26,15,19,0,0,0,0,2121
136,1.4,0.7619047619047619,0.8461538461538461,0.8636363636363636,0.8461538461538461,10.406908919404298,15.589211996700847,19.146734935613736,11.630299110834986,21,39,22,39,10,10,10,10,82,64,81,64,11,29,12,29,0,0,0,0,2122
137,1.4,0.8571428571428571,0.9411764705882353,1.0,0.8181818181818182,10.348383685619426,15.60866843052875,18.422909184112683,11.632098102884036,14,34,17,33,10,10,10,10,89,69,86,70,4,24,7,23,0,0,0,0,2123
138,1.4,0.8636363636363636,0.9411764705882353,0.9354838709677419,0.88,10.384941202398155,14.946368371869847,19.869333552816848,11.153864812872694,22,17,31,25,10,10,10,10,81,86,72,78,12,7,21,15,0,0,0,0,2124
139,1.4,0.9285714285714286,0.9302325581395349,1.0,0.9583333333333334,10.29033058778697,15.752962973191211,18.810364932978548,10.975088102446238,14,43,18,24,10,10,10,10,89,60,85,79,4,33,8,14,0,0,0,0,2125
140,1.5,0.7222222222222222,0.7894736842105263,0.95,0.8823529411764706,10.319945995112,16.494308698765437,20.281712311870088,11.537471134024727,18,57,40,34,10,10,10,10,85,46,63,69,8,47,30,24,0,0,0,0,2126
141,1.5,0.8888888888888888,0.9743589743589743,0.95,0.9166666666666666,10.389706171485802,15.69581027022264,20.69341420919788,11.419472733751785,18,39,40,36,10,10,10,10,85,64,63,67,8,29,30,26,0,0,0,0,2127
142,1.5,0.8333333333333334,0.8484848484848485,0.9523809523809523,0.8333333333333334,10.436871687201911,15.501054041183233,20.385656019414384,11.879709135819217,18,33,42,48,10,10,10,10,85,70,61,55,8,23,32,38,0,0,0,0,2128
143,1.5,1.0,0.9393939393939394,0.9444444444444444,0.8333333333333334,10.381745773014654,15.594088106482728,19.01971528566908,11.430004778920079,10,33,18,18,10,10,10,10,93,70,85,85,0,23,8,8,0,0,0,0,2129
144,1.5,0.7777777777777778,0.9361702127659575,0.9615384615384616,0.875,10.446715368013376,15.948336372681531,19.495803232701988,12.075671580885603,18,47,26,40,10,10,10,10,85,56,77,63,8,37,16,30,0,0,0,0,2130
145,1.5,0.9285714285714286,0.8679245283018868,0.896551724137931,0.92,10.333308230070951,16.191201813060758,19.384965697783482,11.479587659540275,14,53,29,25,10,10,10,10,89,50,74,78,4,43,19,15,0,0,0,0,2131
146,1.5,0.7222222222222222,0.9722222222222222,0.8461538461538461,0.9285714285714286,10.343011041098709,15.6433811749791,19.37805310549131,11.451246901423493,18,36,26,28,10,10,10,10,85,67,77,75,8,26,16,18,0,0,0,0,2132
147,1.5,0.8,0.7560975609756098,0.9393939393939394,0.90625,10.515050846094951,15.752098690066138,19.69281916631575,11.782182539381534,25,41,33,32,10,10,10,10,78,62,70,71,15,31,23,22,0,0,0,0,2133
148,1.5,0.8333333333333334,0.9583333333333334,0.7222222222222222,0.9,10.355361004955967,15.984103249411191,18.623850850824013,11.371274611915547,18,48,18,30,10,10,10,10,85,55,85,73,8,38,8,20,0,0,0,0,2134
149,1.5,0.9,0.85,0.8928571428571429,0.9655172413793104,10.229985577911709,15.740460970340726,19.53853998604951,11.33481386990578,10,40,28,29,10,10,10,10,93,63,75,74,0,30,18,19,0,0,0,0,2135
