,Signal_Upper,coverage_naive,coverage_split50,coverage_split67,coverage_posi,length_naive,length_split50,length_split67,length_posi,nnz_naive,nnz_split50,nnz_split67,nnz_posi,tp_naive,tp_split50,tp_split67,tp_posi,tn_naive,tn_split50,tn_split67,tn_posi,fp_naive,fp_split50,fp_split67,fp_posi,fn_naive,fn_split50,fn_split67,fn_posi,cseed
0,0.2,0.6666666666666666,0.851063829787234,0.7272727272727273,0.9230769230769231,10.309897805937936,16.044044916685518,19.242656836514072,10.750375506589318,12,47,22,26,5,9,5,5,81,50,71,67,7,38,17,21,7,3,7,7,1986
1,0.2,0.8421052631578947,0.9354838709677419,0.9230769230769231,0.9583333333333334,10.435810362004048,15.505328618715172,20.820866764231344,11.836684334756235,19,31,39,24,9,5,9,5,78,62,58,69,10,26,30,19,3,7,3,7,1987
2,0.2,0.8,0.9787234042553191,0.875,1.0,10.387664682019372,16.101148192157446,19.184271402432802,11.222473160042552,15,47,24,13,5,5,5,5,78,46,69,80,10,42,19,8,7,7,7,7,1988
3,0.2,0.6666666666666666,0.8611111111111112,0.9310344827586207,0.95,10.063969584391883,15.47613037374996,19.53958218781602,11.739655600500154,3,36,29,20,0,4,4,0,85,56,63,68,3,32,25,20,12,8,8,12,1989
4,0.2,0.7777777777777778,0.9302325581395349,0.896551724137931,0.9166666666666666,10.232648430811642,15.78851624172613,19.795012787443905,11.175140457090372,9,43,29,24,0,0,5,0,79,45,64,64,9,43,24,24,12,12,7,12,1990
5,0.2,0.8148148148148148,0.9333333333333333,0.8571428571428571,0.9,10.513739505856218,16.744837957024703,19.679750513659734,11.572719583906231,27,60,28,10,12,8,9,7,73,36,69,85,15,52,19,3,0,4,3,5,1991
6,0.2,0.7857142857142857,0.9534883720930233,0.8947368421052632,0.9259259259259259,10.293293784224778,15.909158088159883,18.516692447162246,11.219381163771166,14,43,19,27,9,9,9,9,83,54,78,70,5,34,10,18,3,3,3,3,1992
7,0.2,0.7241379310344828,0.803921568627451,0.8235294117647058,0.9166666666666666,10.536384426789782,16.19892018644476,19.74393248623258,10.883035429263979,29,51,34,24,5,5,5,5,64,42,59,69,24,46,29,19,7,7,7,7,1993
8,0.2,0.6666666666666666,0.9821428571428571,0.7777777777777778,0.9523809523809523,10.352899969508817,16.692931427168627,17.977853927101037,11.026014960115063,18,56,9,21,4,3,4,7,74,35,83,74,14,53,5,14,8,9,8,5,1994
9,0.2,0.8125,0.8333333333333334,0.75,0.9375,10.367887265175396,15.858357280926274,19.388586548153114,11.509511530854123,16,36,24,16,9,4,9,9,81,56,73,81,7,32,15,7,3,8,3,3,1995
10,0.2,0.7857142857142857,0.9333333333333333,1.0,0.9210526315789473,10.322091622842356,15.842108830430389,19.263344971370156,11.240323898035193,14,45,26,38,9,4,7,9,83,47,69,59,5,41,19,29,3,8,5,3,1996
11,0.2,0.8,0.8333333333333334,0.9310344827586207,0.9444444444444444,10.16191268140393,14.890448570368271,19.626241485607267,11.450223413200709,5,18,29,18,5,9,9,8,88,79,68,78,0,9,20,10,7,3,3,4,1997
12,0.2,0.8636363636363636,0.967741935483871,0.875,0.9230769230769231,10.494094529990768,16.600630266735617,19.11844657983784,11.107076276099196,22,62,24,39,8,12,0,12,74,38,64,61,14,50,24,27,4,0,12,0,1998
13,0.2,0.7777777777777778,0.7931034482758621,0.9142857142857143,0.972972972972973,10.436468096394186,15.494364139442428,20.281998385494614,11.016587864597406,18,29,35,37,0,4,3,4,70,63,56,55,18,25,32,33,12,8,9,8,1999
14,0.2,0.6923076923076923,0.9565217391304348,0.918918918918919,0.9230769230769231,10.412134618419238,17.214937742512483,20.185544226374354,11.24748600442348,13,69,37,26,5,9,5,5,80,28,56,67,8,60,32,21,7,3,7,7,2000
15,0.2,0.75,0.8490566037735849,0.8275862068965517,0.926829268292683,10.413663897240642,16.257048571191838,19.41068124894719,11.13038347433355,16,53,29,41,5,9,5,5,77,44,64,52,11,44,24,36,7,3,7,7,2001
16,0.2,0.8888888888888888,0.8780487804878049,0.8421052631578947,0.9,10.381073124185788,15.923806067144715,18.866831221536913,11.281388831192752,18,41,19,40,5,9,9,9,75,56,78,57,13,32,10,31,7,3,3,3,2002
17,0.2,0.4,0.9565217391304348,0.7894736842105263,0.9444444444444444,10.302731293636375,15.05135376395455,18.652317047510046,11.154731271762214,5,23,19,18,0,4,0,0,83,69,69,70,5,19,19,18,12,8,12,12,2003
18,0.2,,0.9285714285714286,0.8421052631578947,0.9,,16.006802690014105,18.9513517174285,11.031718020216982,0,42,19,10,0,5,0,0,88,51,69,78,0,37,19,10,12,7,12,12,2004
19,0.2,0.9230769230769231,0.8636363636363636,0.88,0.9642857142857143,10.331907917068257,15.889898206112367,19.020070664568717,11.181206940673286,13,44,25,28,5,5,8,5,80,49,71,65,8,39,17,23,7,7,4,7,2005
20,0.2,0.7,1.0,1.0,1.0,10.282299892689148,15.585034443845108,19.922933706659343,10.804415921276012,10,34,34,23,0,8,4,8,78,62,58,73,10,26,30,15,12,4,8,4,2006
21,0.2,0.75,0.8372093023255814,0.9090909090909091,0.8928571428571429,10.335822973478308,15.832133380215677,18.652391649479917,10.93947508818926,8,43,22,28,8,8,3,8,88,53,69,68,0,35,19,20,4,4,9,4,2007
22,0.2,0.7741935483870968,0.9245283018867925,0.8983050847457628,0.9130434782608695,10.55689777344802,16.533456153666084,22.072792918269663,11.3147872480519,31,53,59,46,5,12,8,8,62,47,37,50,26,41,51,38,7,0,4,4,2008
23,0.2,0.9166666666666666,0.8947368421052632,1.0,1.0,10.288480566431893,16.439756640638112,19.577099522034544,10.94825917010996,12,57,24,36,8,8,5,8,84,39,69,60,4,49,19,28,4,4,7,4,2009
24,0.2,0.6923076923076923,0.9428571428571428,0.8222222222222222,0.9387755102040817,10.37116307169354,15.476511353960412,20.36746233639936,11.274766694052207,13,35,45,49,0,9,5,12,75,62,48,51,13,26,40,37,12,3,7,0,2010
25,0.2,1.0,0.975,0.9375,0.9655172413793104,10.435920677003274,15.919478150978005,21.27672598270184,11.240331617122266,5,40,48,29,5,9,12,5,88,57,52,64,0,31,36,24,7,3,0,7,2011
26,0.2,0.8333333333333334,0.8679245283018868,0.8823529411764706,0.9090909090909091,10.3539339447415,16.215903582692583,18.372173068246155,11.560250815799767,12,53,17,55,5,8,0,3,81,43,71,36,7,45,17,52,7,4,12,9,2012
27,0.2,0.8636363636363636,0.9230769230769231,0.8695652173913043,0.9038461538461539,10.423385994547859,16.21111774559605,19.115727297964366,10.844639909713786,22,52,23,52,5,0,5,5,71,36,70,41,17,52,18,47,7,12,7,7,2013
28,0.2,,0.9166666666666666,1.0,1.0,,15.551913440904322,18.52110255077719,11.75669554106508,0,36,16,16,0,12,8,0,88,64,80,72,0,24,8,16,12,0,4,12,2014
29,0.2,0.8,0.8529411764705882,0.9473684210526315,0.8888888888888888,10.189844298563305,15.661507615679094,18.636970765302735,11.244234558576851,5,34,19,9,5,0,9,5,88,54,78,84,0,34,10,4,7,12,3,7,2015
30,0.2,0.9,0.875,0.92,1.0,10.188106664918227,15.669119586180084,19.197631434254887,11.75782772503208,10,40,25,20,5,5,5,5,83,53,68,73,5,35,20,15,7,7,7,7,2016
31,0.2,0.7222222222222222,0.8775510204081632,0.8333333333333334,0.8518518518518519,10.450617638782635,16.082888108142726,19.178635515373585,11.379769048634264,18,49,18,27,3,9,3,3,73,48,73,64,15,40,15,24,9,3,9,9,2017
32,0.2,0.7083333333333334,0.8484848484848485,0.8909090909090909,0.8852459016393442,10.507753972188953,16.860768638794305,21.976053619719295,11.326979017374825,24,66,55,61,4,9,5,9,68,31,38,36,20,57,50,52,8,3,7,3,2018
33,0.2,0.75,0.9565217391304348,0.9375,0.96,10.281198988318037,16.194456240236605,18.78525474926144,10.698203932913302,8,46,16,25,8,12,8,8,88,54,80,71,0,34,8,17,4,0,4,4,2019
34,0.2,0.7894736842105263,0.9354838709677419,0.8260869565217391,0.7857142857142857,10.36355213409292,15.642569206345579,19.02462105597012,11.408478635683872,19,31,23,28,4,0,4,9,73,57,69,69,15,31,19,19,8,12,8,3,2020
35,0.2,0.8421052631578947,0.8809523809523809,0.8888888888888888,0.8636363636363636,10.376269399436698,15.730151684495095,19.533420971445157,11.039596924725771,19,42,27,22,9,4,4,9,78,50,65,75,10,38,23,13,3,8,8,3,2021
36,0.2,0.875,0.9272727272727272,1.0,0.9696969696969697,10.30083780948668,16.513280487749693,18.648737817099935,10.81412771209251,8,55,18,33,8,8,8,8,88,41,78,63,0,47,10,25,4,4,4,4,2022
37,0.2,0.7777777777777778,0.9137931034482759,0.9166666666666666,0.9583333333333334,10.369437996151376,16.54468794076647,18.871047351750647,10.908485167696952,18,58,24,24,4,12,9,0,74,42,73,64,14,46,15,24,8,0,3,12,2023
38,0.2,0.6,0.8048780487804879,0.8536585365853658,0.875,10.382589028288114,16.006086698260997,20.338015721978337,10.543558292208267,10,41,41,24,5,9,5,5,83,56,52,69,5,32,36,19,7,3,7,7,2024
39,0.2,0.8,0.8867924528301887,0.9318181818181818,0.9666666666666667,10.393013093052003,16.23003154210626,20.794662794978564,11.41582281440869,15,53,44,30,0,9,4,5,73,44,48,63,15,44,40,25,12,3,8,7,2025
40,0.2,0.8823529411764706,0.8888888888888888,0.9090909090909091,0.9615384615384616,10.344992438980789,15.448512886701321,19.058834811848214,10.889682393946494,17,27,22,26,5,5,5,8,76,66,71,70,12,22,17,18,7,7,7,4,2026
41,0.2,0.8,0.9154929577464789,0.8,0.9354838709677419,10.323632392544123,17.351259251346892,18.811191539732697,10.954223395944531,5,71,15,31,5,9,5,5,88,26,78,62,0,62,10,26,7,3,7,7,2027
42,0.2,0.8421052631578947,0.8461538461538461,0.918918918918919,0.9565217391304348,10.385288543189715,15.55619182568727,20.200826355497995,11.011887206425177,19,39,37,23,4,12,4,4,73,61,55,69,15,27,33,19,8,0,8,8,2028
43,0.2,0.6923076923076923,0.8793103448275862,0.9444444444444444,0.8837209302325582,10.267820429577789,16.468244608171435,19.36268854583966,10.878957808575699,13,58,18,43,4,4,0,9,79,34,70,54,9,54,18,34,8,8,12,3,2029
44,0.2,0.7894736842105263,0.8461538461538461,0.78125,0.9148936170212766,10.375376993115815,16.943242309882624,19.948718414372465,10.786923072766816,19,65,32,47,4,5,4,5,73,28,60,46,15,60,28,42,8,7,8,7,2030
45,0.2,0.75,0.8333333333333334,0.9295774647887324,0.9365079365079365,10.474694315705351,15.901258897447779,23.766081876492613,11.105143582427209,24,42,71,63,0,5,0,5,64,51,17,30,24,37,71,58,12,7,12,7,2031
46,0.2,0.8666666666666667,0.8636363636363636,0.9655172413793104,0.9259259259259259,10.397677266262592,15.854419023146948,19.32215098218966,10.899628454417703,15,44,29,27,5,0,9,8,78,44,68,69,10,44,20,19,7,12,3,4,2032
47,0.2,0.7777777777777778,0.9130434782608695,0.8095238095238095,0.9354838709677419,10.213475397429473,15.873035014767098,20.876699674637575,11.239517680534698,9,46,42,62,9,4,9,4,88,46,55,30,0,42,33,58,3,8,3,8,2033
48,0.2,1.0,0.9591836734693877,0.8666666666666667,1.0,10.24523168605172,15.855823959993147,18.920460700915445,11.13020994184572,5,49,15,18,5,8,5,5,88,47,78,75,0,41,10,13,7,4,7,7,2034
49,0.2,0.8421052631578947,0.9384615384615385,0.8888888888888888,0.9743589743589743,10.394949775202605,16.94804566404791,18.749886925674353,11.000075576606989,19,65,18,39,5,12,0,0,74,35,70,49,14,53,18,39,7,0,12,12,2035
50,0.2,0.7777777777777778,0.8867924528301887,0.9259259259259259,0.8695652173913043,10.408851971065143,16.13523019222685,19.586442809173356,11.022231549408898,18,53,27,23,0,4,4,0,70,39,65,65,18,49,23,23,12,8,8,12,2036
51,0.2,0.7222222222222222,0.9491525423728814,0.8275862068965517,0.85,10.319695236921644,16.48442097168501,19.306320751658113,10.701938997787702,18,59,29,60,5,9,9,9,75,38,68,37,13,50,20,51,7,3,3,3,2037
52,0.2,0.8,0.9074074074074074,0.9242424242424242,0.9032258064516129,10.508292282012079,16.214818614734707,22.62621642591626,11.036749628090197,25,54,66,62,5,8,9,9,68,42,31,35,20,46,57,53,7,4,3,3,2038
53,0.2,0.8,0.8648648648648649,0.95,1.0,10.247525582060169,15.576482766485675,19.262613306698807,11.32370078547984,5,37,20,9,0,9,4,0,83,60,72,79,5,28,16,9,12,3,8,12,2039
54,0.2,0.7777777777777778,0.9032258064516129,0.8666666666666667,0.85,10.401445239340585,15.434691562881927,19.970839424824938,11.197036637099803,9,31,30,20,5,9,5,5,84,66,63,73,4,22,25,15,7,3,7,7,2040
55,0.2,0.7,0.8064516129032258,0.9,0.918918918918919,10.346505473058027,15.68981395840705,19.2121674687486,11.283431512034445,10,31,20,37,0,7,7,12,78,64,75,63,10,24,13,25,12,5,5,0,2041
56,0.2,1.0,0.9047619047619048,0.8421052631578947,0.975,10.21319042031745,15.782310394823737,18.52423648225755,11.1182678921508,4,42,19,40,4,8,5,9,88,54,74,57,0,34,14,31,8,4,7,3,2042
57,0.2,0.7222222222222222,0.9821428571428571,0.9354838709677419,0.9090909090909091,10.322000077379903,16.437882858755557,19.955684253206275,11.514320364365755,18,56,31,33,0,12,5,4,70,44,62,59,18,44,26,29,12,0,7,8,2043
58,0.2,0.9166666666666666,0.8837209302325582,0.9285714285714286,0.9411764705882353,10.506012165788752,15.78318008950352,19.747627621368277,10.811132831768813,24,43,28,34,9,9,9,9,73,54,69,63,15,34,19,25,3,3,3,3,2044
59,0.2,0.5714285714285714,0.8813559322033898,0.8148148148148148,0.9655172413793104,10.211198612026108,16.517726090072586,19.534349927185463,11.480879307831007,7,59,27,29,3,3,3,0,84,32,64,59,4,56,24,29,9,9,9,12,2045
60,0.2,1.0,0.8958333333333334,1.0,0.9487179487179487,10.189774780572773,16.11818397135331,18.409753974656756,10.718108035424457,5,48,13,39,5,9,9,5,88,49,84,54,0,39,4,34,7,3,3,7,2046
61,0.2,0.7333333333333333,0.8636363636363636,1.0,0.9285714285714286,10.279806560308652,15.971989553033351,19.616294492581634,11.295831634464134,15,44,24,28,5,12,8,8,78,56,72,68,10,32,16,20,7,0,4,4,2047
62,0.2,0.75,0.8205128205128205,0.875,0.875,10.338017607517429,15.782200380486355,18.043000406803863,12.479694369893602,12,39,8,24,4,9,5,12,80,58,85,76,8,30,3,12,8,3,7,0,2048
63,0.2,0.75,0.9032258064516129,0.9705882352941176,0.9285714285714286,10.308716272754541,16.692783135770046,19.877002514784092,11.298718394057316,16,62,34,42,0,9,5,5,72,35,59,51,16,53,29,37,12,3,7,7,2049
64,0.2,0.8,0.8837209302325582,0.8333333333333334,0.8571428571428571,10.184493396172988,15.88830543745726,19.30962721025747,10.684455728132916,5,43,24,14,5,5,8,9,88,50,72,83,0,38,16,5,7,7,4,3,2050
65,0.2,0.6923076923076923,0.9074074074074074,0.84,0.9655172413793104,10.273716266225021,16.2689523668831,21.408956645329635,11.226804199353115,13,54,50,29,8,8,12,5,83,42,50,64,5,46,38,24,4,4,0,7,2051
66,0.2,0.6153846153846154,0.9722222222222222,0.9615384615384616,0.9444444444444444,10.317304050390463,15.5960575122209,19.136743000672954,11.456033250552666,13,36,26,18,5,12,12,4,80,64,74,74,8,24,14,14,7,0,0,8,2052
67,0.2,0.7619047619047619,0.8867924528301887,0.9259259259259259,0.8979591836734694,10.416879942019941,16.377497244862163,19.227148847349607,10.985525342476224,21,53,27,49,5,8,5,5,72,43,66,44,16,45,22,44,7,4,7,7,2053
68,0.2,0.7777777777777778,0.975609756097561,0.75,1.0,10.272075913221716,15.829026634303352,19.528131646571605,11.381755320576838,9,41,28,21,5,9,5,9,84,56,65,76,4,32,23,12,7,3,7,3,2054
69,0.2,0.8,0.84375,0.8571428571428571,1.0,10.42817236875231,15.601308680421035,19.902264772666744,12.791490208550924,10,32,35,7,0,3,0,3,78,59,53,84,10,29,35,4,12,9,12,9,2055
70,0.2,0.75,0.8636363636363636,0.8,1.0,10.177559805356621,15.143763314318242,19.304179912186786,11.50552034745627,4,22,25,25,0,4,5,5,84,70,68,68,4,18,20,20,12,8,7,7,2056
71,0.2,0.8181818181818182,0.8909090909090909,0.7727272727272727,1.0,10.44357409287594,16.34992206061564,19.106536213322087,10.869946409323838,22,55,22,19,9,9,4,5,75,42,70,74,13,46,18,14,3,3,8,7,2057
72,0.2,0.8,0.9375,0.9230769230769231,0.95,10.330853098516561,16.157453103013424,18.312682651159832,10.398787701588578,15,48,13,20,0,9,5,0,73,49,80,68,15,39,8,20,12,3,7,12,2058
73,0.2,0.8,0.9272727272727272,0.9230769230769231,0.9444444444444444,10.251332727723224,16.4543059515669,18.572878040711853,11.118050072687064,5,55,13,18,0,8,5,0,83,41,80,70,5,47,8,18,12,4,7,12,2059
74,0.2,0.8,1.0,0.8461538461538461,0.9375,10.25235943921091,16.234676128832252,18.587594142432554,11.429489714299912,5,51,13,32,5,9,9,8,88,46,84,64,0,42,4,24,7,3,3,4,2060
75,0.2,1.0,0.8723404255319149,0.8095238095238095,0.9393939393939394,10.146589544016347,16.135465179081645,19.04673188891608,11.272435772890628,4,47,21,33,0,9,3,5,84,50,70,60,4,38,18,28,12,3,9,7,2061
76,0.2,,0.9210526315789473,0.9696969696969697,0.9433962264150944,,15.534040699633298,19.497994653911967,11.099444346461537,0,38,33,53,0,5,3,9,88,55,58,44,0,33,30,44,12,7,9,3,2062
77,0.2,0.7647058823529411,0.9032258064516129,0.9655172413793104,0.75,10.370547104177648,15.528036663789916,19.945977699743224,11.307767256595103,17,31,29,16,5,9,12,0,76,66,71,72,12,22,17,16,7,3,0,12,2063
78,0.2,1.0,0.9696969696969697,0.9629629629629629,1.0,10.166266135669064,15.36481614167109,19.33048925006903,10.550399886624184,8,33,27,22,5,8,9,5,85,63,70,71,3,25,18,17,7,4,3,7,2064
79,0.2,0.5882352941176471,0.8695652173913043,0.8035714285714286,0.875,10.405603258905941,16.046179169763516,22.546236687583093,10.962957462710014,17,46,56,32,9,9,7,5,80,51,39,61,8,37,49,27,3,3,5,7,2065
80,0.2,0.8333333333333334,0.8936170212765957,0.8421052631578947,1.0,10.249176850586206,16.0757500853064,19.386197680215627,11.72420106922178,6,47,19,23,0,3,0,5,82,44,69,70,6,44,19,18,12,9,12,7,2066
81,0.2,0.6666666666666666,0.935064935064935,0.9302325581395349,0.9473684210526315,10.292874057516007,17.61291757041316,20.563209305285678,10.780910149245623,12,77,43,19,9,12,12,9,85,23,57,78,3,65,31,10,3,0,0,3,2067
82,0.2,0.8666666666666667,0.9772727272727273,0.9615384615384616,0.9545454545454546,10.355572279386,15.905348788846412,18.97668566037207,10.784144486483159,15,44,26,22,5,5,12,12,78,49,74,78,10,39,14,10,7,7,0,0,2068
83,0.2,0.7058823529411765,0.8666666666666667,0.8636363636363636,0.9024390243902439,10.343655119495043,15.973138825456191,19.26387361280298,10.803570844830624,17,45,22,41,7,7,8,12,78,50,74,59,10,38,14,29,5,5,4,0,2069
84,0.2,0.625,0.9148936170212766,0.8333333333333334,0.875,10.21776039432727,15.811961566811629,18.79419224140473,11.706447182873987,8,47,18,8,4,9,4,4,84,50,74,84,4,38,14,4,8,3,8,8,2070
85,0.2,0.875,0.8571428571428571,0.9230769230769231,0.9230769230769231,10.385216919018724,15.502144008277119,20.00816207501925,11.48304325880996,8,28,26,13,0,5,5,4,80,65,67,79,8,23,21,9,12,7,7,8,2071
86,0.2,0.75,0.9090909090909091,0.8181818181818182,0.9375,10.285649932121814,15.831849478237531,18.408841337344963,11.484658423538795,8,44,11,32,0,9,0,5,80,53,77,61,8,35,11,27,12,3,12,7,2072
87,0.2,1.0,0.8636363636363636,0.9555555555555556,1.0,10.284886812080742,15.877704474186883,20.868338400339944,11.690926158269496,5,44,45,32,5,12,12,12,88,56,55,68,0,32,33,20,7,0,0,0,2073
88,0.2,0.8,0.8260869565217391,1.0,0.8888888888888888,10.2930403112458,15.912450862135984,19.56717349592181,10.929873835251197,5,46,12,18,5,9,9,8,88,51,85,78,0,37,3,10,7,3,3,4,2074
89,0.2,0.8695652173913043,0.9272727272727272,0.8709677419354839,1.0,10.470111592445374,16.46980658012532,19.88439639486346,11.265602981334267,23,55,31,27,9,12,9,0,74,45,66,61,14,43,22,27,3,0,3,12,2075
90,0.2,0.88,0.9285714285714286,0.9821428571428571,0.9459459459459459,10.504843670940316,15.978851745988173,22.09209254210364,11.257696882917097,25,42,56,37,5,9,4,4,68,55,36,55,20,33,52,33,7,3,8,8,2076
91,0.2,0.7894736842105263,0.8709677419354839,0.8717948717948718,0.9743589743589743,10.380062007941023,15.545939263960761,20.15079353867239,10.797152357631818,19,31,39,39,4,4,5,0,73,61,54,49,15,27,34,39,8,8,7,12,2077
92,0.2,0.8461538461538461,0.9264705882352942,0.8666666666666667,0.9583333333333334,10.2940095818112,17.004327405309322,18.750293564372388,10.791390135996828,13,68,15,48,8,12,5,8,83,32,78,48,5,56,10,40,4,0,7,4,2078
93,0.2,0.8,0.896551724137931,0.95,1.0,10.277266792843312,15.230578000895232,19.440553864247605,12.27347460146138,5,29,20,12,5,8,5,8,88,67,73,84,0,21,15,4,7,4,7,4,2079
94,0.2,0.5625,0.8461538461538461,0.8846153846153846,1.0,10.415242202988136,16.3522029462597,19.420116983533315,11.442918761848603,16,52,26,20,5,5,5,12,77,41,67,80,11,47,21,8,7,7,7,0,2080
95,0.2,0.6944444444444444,0.8181818181818182,0.8918918918918919,0.9230769230769231,10.594230634954792,16.069579082243816,20.23156070216203,10.977973415021953,36,44,37,39,9,9,12,4,61,53,63,53,27,35,25,35,3,3,0,8,2081
96,0.2,0.8076923076923077,0.92,0.8809523809523809,0.9166666666666666,10.476406786969939,16.03884463044788,20.7157315132649,10.50919582088837,26,50,42,48,12,9,12,8,74,47,58,48,14,41,30,40,0,3,0,4,2082
97,0.2,0.5,0.86,0.8947368421052632,0.9459459459459459,10.185487546349048,16.009743720159832,18.605534461600676,11.040964750213236,4,50,19,37,4,7,4,4,88,45,73,55,0,43,15,33,8,5,8,8,2083
98,0.2,0.6538461538461539,0.8367346938775511,0.8301886792452831,0.8148148148148148,10.473295268378775,16.278990580501205,21.763802982107027,10.47717992973091,26,49,53,27,3,8,7,4,65,47,42,65,23,41,46,23,9,4,5,8,2084
99,0.2,0.6923076923076923,0.9142857142857143,0.9333333333333333,0.8571428571428571,10.26778137361133,15.39505778122222,19.96698349992968,11.403131096780967,13,35,30,49,9,12,5,8,84,65,63,47,4,23,25,41,3,0,7,4,2085
100,0.5,0.8333333333333334,0.967741935483871,0.8666666666666667,0.9333333333333333,10.367691633179602,15.52251917577528,18.785041554382907,11.094478788045892,12,31,15,15,8,8,5,8,84,65,78,81,4,23,10,7,4,4,7,4,2086
101,0.5,0.8181818181818182,0.8809523809523809,0.8333333333333334,1.0,10.195208514704227,15.753660825695038,19.752635776133832,10.769826571010537,11,42,30,23,8,8,8,8,85,54,66,73,3,34,22,15,4,4,4,4,2087
102,0.5,0.75,0.95,1.0,0.918918918918919,10.148207664728815,15.923902062149716,19.277172298796625,10.979372075625454,8,40,24,37,5,5,5,5,85,53,69,56,3,35,19,32,7,7,7,7,2088
103,0.5,0.8181818181818182,0.9038461538461539,0.9387755102040817,0.9137931034482759,10.726569717280869,16.215693940981883,21.38309842192693,10.770384820050477,44,52,49,58,9,5,0,4,53,41,39,34,35,47,49,54,3,7,12,8,2089
104,0.5,0.7931034482758621,0.921875,0.8928571428571429,0.8275862068965517,10.516324103679809,16.870504242278685,19.492482669793166,10.895850015527953,29,64,28,29,9,9,9,12,68,33,69,71,20,55,19,17,3,3,3,0,2090
105,0.5,0.7391304347826086,0.8611111111111112,0.8518518518518519,0.926829268292683,10.377024503829885,15.690276129868275,19.63559654186996,11.238434909673483,23,36,27,41,9,9,9,9,74,61,70,56,14,27,18,32,3,3,3,3,2091
106,0.5,0.8571428571428571,0.8867924528301887,0.9285714285714286,0.9117647058823529,10.29878682229253,16.126222364445947,19.67939960276278,10.88308340401562,14,53,28,34,9,8,8,12,83,43,68,66,5,45,20,22,3,4,4,0,2092
107,0.5,0.8095238095238095,0.8,0.8260869565217391,0.9444444444444444,10.383809370293156,15.717878702011394,20.82299850555012,10.745550580259442,21,40,46,36,12,12,12,12,79,60,54,64,9,28,34,24,0,0,0,0,2093
108,0.5,0.7586206896551724,0.8620689655172413,0.896551724137931,0.8181818181818182,10.53938728427146,16.60586246880402,19.640974053310526,10.864273611228143,29,58,29,44,12,9,12,12,71,39,71,56,17,49,17,32,0,3,0,0,2094
109,0.5,0.6666666666666666,0.8,0.8928571428571429,0.9090909090909091,10.254391369470747,15.744320822507143,19.594989420627634,11.311240233871244,12,40,28,22,8,12,12,8,84,60,72,74,4,28,16,14,4,0,0,4,2095
110,0.5,0.7777777777777778,0.9545454545454546,0.9285714285714286,0.9285714285714286,10.249180822087968,15.07652869034497,19.523864541729573,10.829811181828731,9,22,28,14,9,9,9,9,88,75,69,83,0,13,19,5,3,3,3,3,2096
111,0.5,0.5555555555555556,0.8695652173913043,0.9375,1.0,10.22973733826753,15.915521057608615,20.040212941172726,11.152196839783924,9,46,32,31,9,7,9,7,88,49,65,64,0,39,23,24,3,5,3,5,2097
112,0.5,0.8,0.896551724137931,0.9090909090909091,0.9333333333333333,10.35896580011834,15.345597256434115,19.103542740137833,10.949149022105537,15,29,22,15,12,9,9,12,85,68,75,85,3,20,13,3,0,3,3,0,2098
113,0.5,0.5555555555555556,0.8571428571428571,0.7419354838709677,0.7857142857142857,10.28175168536314,15.173795249920342,19.69753085154221,10.992319524053629,9,28,31,14,9,9,12,9,88,69,69,83,0,19,19,5,3,3,0,3,2099
114,0.5,0.8,0.9285714285714286,1.0,0.9565217391304348,10.183330037622541,15.785673253884898,18.186145532392267,11.12494280934373,5,42,8,23,5,12,8,9,88,58,88,74,0,30,0,14,7,0,4,3,2100
115,0.5,0.7741935483870968,0.8596491228070176,0.9230769230769231,0.9130434782608695,10.563122903259847,16.75360879442207,22.07810522550426,11.270852881530713,31,57,52,46,5,9,9,5,62,40,45,47,26,48,43,41,7,3,3,7,2101
116,0.5,0.7941176470588235,0.8641975308641975,0.9393939393939394,0.9,10.570927437203105,17.742711827461434,19.903078273682297,11.262281695242478,34,81,33,60,9,12,5,12,63,19,60,40,25,69,28,48,3,0,7,0,2102
117,0.5,0.631578947368421,0.9591836734693877,0.8709677419354839,0.8333333333333334,10.384860905726406,16.161559279240393,20.0401054325963,11.025491302725047,19,49,31,36,9,12,12,12,78,51,69,64,10,37,19,24,3,0,0,0,2103
118,0.5,0.7727272727272727,0.9545454545454546,1.0,0.9523809523809523,10.420424252517769,14.918800573398029,20.547379092847855,11.030514265637104,22,22,40,21,12,12,12,12,78,78,60,79,10,10,28,9,0,0,0,0,2104
119,0.5,0.75,0.96,0.7692307692307693,0.8333333333333334,10.289761304212904,16.283994932813926,19.64327972750797,10.610226513802253,12,50,26,12,8,7,9,5,84,45,71,81,4,43,17,7,4,5,3,7,2105
120,0.5,0.8571428571428571,0.9743589743589743,0.896551724137931,0.9777777777777777,10.478651632075914,15.787783332555883,19.673062615105323,10.87571545256268,21,39,29,45,12,9,7,12,79,58,66,55,9,30,22,33,0,3,5,0,2106
121,0.5,1.0,0.9512195121951219,0.8695652173913043,1.0,10.246548554557872,15.679379599375551,19.40899808563492,10.777456573277616,5,41,23,19,5,5,5,9,88,52,70,78,0,36,18,10,7,7,7,3,2107
122,0.5,0.8888888888888888,0.8095238095238095,0.8648648648648649,0.9333333333333333,10.24203828353322,15.789766716880157,20.14607839181526,11.148307869790148,9,42,37,30,9,9,9,8,88,55,60,66,0,33,28,22,3,3,3,4,2108
123,0.5,0.5,0.8,0.7058823529411765,0.8620689655172413,10.250712653619471,15.037218896539553,18.886045831776695,11.034090783379126,10,20,17,29,5,5,5,5,83,73,76,64,5,15,12,24,7,7,7,7,2109
124,0.5,0.8571428571428571,0.8648648648648649,0.9047619047619048,0.9655172413793104,10.364280097153713,15.631240547540209,19.100645701800154,10.842226468800778,14,37,21,29,5,8,8,5,79,59,75,64,9,29,13,24,7,4,4,7,2110
125,0.5,0.8333333333333334,0.8666666666666667,1.0,1.0,10.263464553959356,15.911947572532512,20.009056758792926,11.350854310208671,12,45,30,34,5,5,9,5,81,48,67,59,7,40,21,29,7,7,3,7,2111
126,0.5,0.8,0.8823529411764706,0.9310344827586207,0.9032258064516129,10.431905361336769,15.731542088721126,19.1423860191925,10.664457410392293,15,34,29,31,5,8,5,9,78,62,64,66,10,26,24,22,7,4,7,3,2112
127,0.5,0.9333333333333333,0.8928571428571429,0.9230769230769231,0.9318181818181818,10.418490711861345,16.27861529281383,20.315508990107002,11.302755564656609,15,56,39,44,12,12,12,12,85,44,61,56,3,44,27,32,0,0,0,0,2113
128,0.5,0.7,0.8823529411764706,0.9655172413793104,0.9696969696969697,10.367910402908715,15.542239593051939,20.01119148898982,11.229453225466772,10,34,29,33,5,5,9,9,83,59,68,64,5,29,20,24,7,7,3,3,2114
129,0.5,0.75,0.9347826086956522,0.90625,0.9736842105263158,10.268523816421078,16.083854260096977,19.846696756715186,10.936071428868345,12,46,32,38,9,9,9,9,85,51,65,59,3,37,23,29,3,3,3,3,2115
130,0.5,,0.9767441860465116,1.0,0.8666666666666667,,16.05395564530155,19.277722507221576,10.730256198188375,0,43,20,15,0,0,0,5,88,45,68,78,0,43,20,10,12,12,12,7,2116
131,0.5,0.8333333333333334,0.9615384615384616,0.8857142857142857,0.90625,10.340663471105975,15.35970252902322,20.324832253336012,10.807824622717678,18,26,35,32,5,5,5,9,75,67,58,65,13,21,30,23,7,7,7,3,2117
132,0.5,0.8125,0.8947368421052632,0.84,0.9444444444444444,10.394556318487979,15.76661847816268,19.15638074710554,10.919294601647367,16,38,25,36,9,9,9,9,81,59,72,61,7,29,16,27,3,3,3,3,2118
133,0.5,0.9285714285714286,0.8367346938775511,0.9393939393939394,0.9393939393939394,10.357232460921006,16.04920179917131,20.075566522538534,10.498370454317891,14,49,33,33,9,12,9,9,83,51,64,64,5,37,24,24,3,0,3,3,2119
134,0.5,0.8666666666666667,0.9565217391304348,0.8888888888888888,0.8723404255319149,10.293771401295858,16.018174449781203,20.85705503531504,11.245987841962714,15,46,45,47,5,12,12,12,78,54,55,53,10,34,33,35,7,0,0,0,2120
135,0.5,0.7894736842105263,0.9310344827586207,0.9019607843137255,0.8775510204081632,10.328210795051236,16.460069992098575,21.80241001386917,11.055986692805613,19,58,51,49,5,9,8,8,74,39,45,47,14,49,43,41,7,3,4,4,2121
136,0.5,0.8888888888888888,0.9473684210526315,0.875,0.9393939393939394,10.21371116146314,16.53286324782833,19.423339118575704,11.188347064799078,9,57,32,33,9,12,9,9,88,43,65,64,0,45,23,24,3,0,3,3,2122
137,0.5,0.5,1.0,0.8064516129032258,0.9230769230769231,10.224514312655124,15.53274568564803,19.567019448837158,11.053851391688287,8,37,31,26,8,12,12,12,88,63,69,74,0,25,19,14,4,0,0,0,2123
138,0.5,0.6071428571428571,0.8,0.8913043478260869,0.8780487804878049,10.498147354422942,15.793502676821674,20.80333216011244,11.206346115494874,28,40,46,41,9,8,12,12,69,56,54,59,19,32,34,29,3,4,0,0,2124
139,0.5,0.8333333333333334,0.85,0.9473684210526315,0.9090909090909091,10.303420485931058,16.61957801468018,19.926743671134567,10.965584848976555,12,60,38,44,9,4,7,12,85,32,57,56,3,56,31,32,3,8,5,0,2125
140,0.5,0.8421052631578947,0.8333333333333334,0.9259259259259259,0.9090909090909091,10.339485551528142,15.740775973770383,19.822391628797345,11.015907027191307,19,42,27,33,9,9,4,9,78,55,65,64,10,33,23,24,3,3,8,3,2126
141,0.5,0.7647058823529411,0.9772727272727273,0.8478260869565217,0.8955223880597015,10.374609235514376,15.879774966680014,20.86319200221465,11.309522693047326,17,44,46,67,4,4,4,9,75,48,46,30,13,40,42,58,8,8,8,3,2127
142,0.5,0.875,0.8,0.9090909090909091,0.9259259259259259,10.356599914753025,15.90203653019542,20.578611771911472,10.79641651334391,16,40,44,27,9,5,9,5,81,53,53,66,7,35,35,22,3,7,3,7,2128
143,0.5,0.6216216216216216,0.8507462686567164,0.9342105263157895,0.9180327868852459,10.59984516598245,16.728442274040198,24.156343813941813,11.019378605384876,37,67,76,61,5,5,8,8,56,26,20,35,32,62,68,53,7,7,4,4,2129
144,0.5,0.9,0.8620689655172413,0.90625,1.0,10.259097415123609,15.310552707289913,19.776338478314724,11.39708955236548,10,29,32,30,5,5,5,5,83,64,61,63,5,24,27,25,7,7,7,7,2130
145,0.5,,0.8983050847457628,0.9565217391304348,0.9473684210526315,,16.74643433415208,19.40809203580324,11.159031091918054,0,59,23,38,0,5,5,8,88,34,70,58,0,54,18,30,12,7,7,4,2131
146,0.5,0.9,0.9714285714285714,0.8947368421052632,1.0,10.256151028633074,17.193634387573248,20.366916325655733,10.806883320442502,10,70,38,29,5,8,9,0,83,26,59,59,5,62,29,29,7,4,3,12,2132
147,0.5,0.8571428571428571,0.9736842105263158,1.0,0.9230769230769231,10.38015092657017,15.6543215287821,19.494489542109505,11.283810192407968,14,38,23,13,4,9,0,4,78,59,65,79,10,29,23,9,8,3,12,8,2133
148,0.5,0.7777777777777778,0.875,0.8823529411764706,0.926829268292683,10.341346347507166,16.83732749009305,18.97003871023375,11.00770380690822,9,64,17,41,5,9,9,9,84,33,80,56,4,55,8,32,7,3,3,3,2134
149,0.5,0.6666666666666666,0.9142857142857143,0.9444444444444444,0.975609756097561,10.14928320216687,15.541367654584946,20.55481866247754,10.978216423249515,3,35,36,41,3,7,12,7,88,60,64,54,0,28,24,34,9,5,0,5,2135
150,0.5,0.9285714285714286,0.8983050847457628,0.8461538461538461,0.9818181818181818,10.392056722315832,16.468991411683017,18.458343680835092,11.257551472993166,14,59,13,55,9,7,8,12,83,36,83,45,5,52,5,43,3,5,4,0,2136
151,0.5,0.5,0.9148936170212766,0.84,1.0,10.207708336339033,15.98940138197725,19.086719323354316,11.38183364642843,8,47,25,22,8,12,12,8,88,53,75,74,0,35,13,14,4,0,0,4,2137
152,0.5,0.8947368421052632,0.9302325581395349,0.7,0.9629629629629629,10.403002990408252,15.862054861258631,18.326042100564433,11.103552291193784,19,43,10,27,9,9,0,9,78,54,78,70,10,34,10,18,3,3,12,3,2138
153,0.5,0.625,0.9302325581395349,0.9523809523809523,0.8333333333333334,10.238555158243699,15.855702841169144,19.14974934970019,11.066022085915789,8,43,21,18,5,5,5,5,85,50,72,75,3,38,16,13,7,7,7,7,2139
154,0.5,1.0,0.9074074074074074,0.8863636363636364,1.0,10.304583422701608,16.279546976800162,20.880554172112713,11.18501839010692,5,54,44,14,5,9,5,9,88,43,49,83,0,45,39,5,7,3,7,3,2140
155,0.5,0.8181818181818182,0.8035714285714286,0.9215686274509803,1.0,10.381641226855745,16.46875370008501,21.621713893438358,10.73795072900413,22,56,51,45,12,12,12,12,78,44,49,55,10,44,39,33,0,0,0,0,2141
156,0.5,0.76,0.8518518518518519,0.9393939393939394,0.8363636363636363,10.403310455047288,16.27356289010573,19.577997342068254,10.748410477838032,25,54,33,55,5,12,8,8,68,46,63,41,20,42,25,47,7,0,4,4,2142
157,0.5,0.7948717948717948,0.9117647058823529,0.8363636363636363,0.851063829787234,10.67252207061623,15.638038860509937,21.741767217939802,10.899307555418057,39,34,55,47,8,8,8,12,57,62,41,53,31,26,47,35,4,4,4,0,2143
158,0.5,0.6666666666666666,0.90625,0.90625,0.875,10.246623197267084,15.560381845233788,19.826603188332395,11.086817088157218,9,32,32,16,0,0,9,7,79,56,65,79,9,32,23,9,12,12,3,5,2144
159,0.5,0.625,0.8235294117647058,0.9411764705882353,0.918918918918919,10.259379360343484,16.17830245521897,18.602571502033435,11.628752713595603,8,51,17,37,3,3,3,3,83,40,74,54,5,48,14,34,9,9,9,9,2145
160,0.5,0.5,0.90625,1.0,0.918918918918919,10.27600202432174,15.563437328882197,18.015345608616517,11.227191419879151,4,32,4,37,4,7,4,12,88,63,88,63,0,25,0,25,8,5,8,0,2146
161,0.5,0.7241379310344828,0.9393939393939394,0.9259259259259259,0.9523809523809523,10.478196622399368,16.883792964002883,19.3461857292654,10.853852464052807,29,66,27,42,5,5,9,5,64,27,70,51,24,61,18,37,7,7,3,7,2147
162,0.5,1.0,0.9607843137254902,0.8620689655172413,0.9666666666666667,10.309817541134477,16.404839451804023,19.588235497593292,11.095240432770305,5,51,29,30,5,12,9,5,88,49,68,63,0,39,20,25,7,0,3,7,2148
163,0.5,0.7837837837837838,0.8333333333333334,0.7735849056603774,0.8571428571428571,10.547262539158652,16.374663740406813,21.82018558495809,10.585401611329255,37,54,53,56,12,12,12,12,63,46,47,44,25,42,41,44,0,0,0,0,2149
164,0.5,0.8888888888888888,0.926829268292683,0.9090909090909091,1.0,10.238337408029926,15.707679155953798,19.700824677738527,11.535762731874685,9,41,33,33,5,9,9,9,84,56,64,64,4,32,24,24,7,3,3,3,2150
165,0.5,0.6363636363636364,0.8857142857142857,0.9333333333333333,0.92,10.334291131120013,17.057121132745834,18.703767654845272,11.1284884119433,11,70,15,25,8,8,8,8,85,26,81,71,3,62,7,17,4,4,4,4,2151
166,0.5,0.7142857142857143,0.975,0.9545454545454546,0.9111111111111111,10.324085191028646,15.777772167145528,19.22154105275297,11.224861660308996,14,40,22,45,5,5,9,9,79,53,75,52,9,35,13,36,7,7,3,3,2152
167,0.5,0.8181818181818182,0.8571428571428571,0.9322033898305084,0.9142857142857143,10.464053428731814,16.843825574884523,21.97677707705274,10.860924650209874,22,63,59,35,9,12,12,12,75,37,41,65,13,51,47,23,3,0,0,0,2153
168,0.5,0.6,0.8421052631578947,1.0,0.875,10.124684045824562,14.91626837143748,17.750553597181458,11.381792356809365,5,19,5,8,0,8,0,3,83,77,83,83,5,11,5,5,12,4,12,9,2154
169,0.5,0.7142857142857143,0.9090909090909091,0.9534883720930233,0.92,10.363298023596565,15.522377230708322,20.378320383294707,11.068403695286756,14,33,43,25,5,5,5,5,79,60,50,68,9,28,38,20,7,7,7,7,2155
170,0.5,0.8461538461538461,0.8947368421052632,0.8571428571428571,0.9534883720930233,10.277690231381559,17.311180773074224,18.647586295764274,11.226817753176897,13,76,14,43,5,9,5,9,80,21,79,54,8,67,9,34,7,3,7,3,2156
171,0.5,0.6,0.8974358974358975,0.75,1.0,10.283818805003744,15.801354333767462,19.488689301288318,11.401029097728035,5,39,24,49,5,5,5,5,88,54,69,44,0,34,19,44,7,7,7,7,2157
172,0.5,0.8333333333333334,0.9111111111111111,0.875,0.8888888888888888,10.232747165554631,16.10126320134407,19.308476531622997,11.110392904664401,12,45,24,36,8,12,5,12,84,55,69,64,4,33,19,24,4,0,7,0,2158
173,0.5,1.0,0.8620689655172413,0.8064516129032258,0.896551724137931,10.23825822638241,16.67936000683703,19.43278756082328,10.983447310578661,5,58,31,29,5,8,5,5,88,38,62,64,0,50,26,24,7,4,7,7,2159
174,0.5,0.8,0.8392857142857143,0.9523809523809523,0.9024390243902439,10.155666415913391,16.405630029287433,18.95777133021096,10.915563686343441,5,56,21,41,5,12,5,12,88,44,72,59,0,44,16,29,7,0,7,0,2160
175,0.5,0.8888888888888888,0.9354838709677419,0.8857142857142857,1.0,10.290863344058241,15.467389019932497,19.728777393139513,10.70319117413718,9,31,35,23,9,9,12,5,88,66,65,70,0,22,23,18,3,3,0,7,2161
176,0.5,0.8235294117647058,0.88,0.925,0.9459459459459459,10.304433752455434,16.15226068219709,20.73387297810715,11.091032816276613,17,50,40,37,12,12,12,12,83,50,60,63,5,38,28,25,0,0,0,0,2162
177,0.5,1.0,0.8620689655172413,0.7777777777777778,1.0,10.250037405114487,15.373645349231504,18.399692147632706,11.181905285471945,5,29,9,9,5,5,5,5,88,64,84,84,0,24,4,4,7,7,7,7,2163
178,0.5,0.8571428571428571,0.9444444444444444,0.9433962264150944,0.8888888888888888,10.348745013107479,17.23586633266441,21.593503676533665,10.860404077679938,14,72,53,18,9,9,9,9,83,25,44,79,5,63,44,9,3,3,3,3,2164
179,0.5,0.7857142857142857,0.9666666666666667,0.9714285714285714,1.0,10.37497967514911,15.343591450572088,19.84219690117604,11.406160994062953,14,30,35,40,9,9,9,12,83,67,62,60,5,21,26,28,3,3,3,0,2165
180,0.5,0.6818181818181818,0.8571428571428571,0.8285714285714286,0.8,10.455626112851569,15.985649328548684,19.834500723100316,11.336538600441346,22,42,35,25,12,12,8,7,78,58,61,70,10,30,27,18,0,0,4,5,2166
181,0.5,0.6923076923076923,0.8913043478260869,0.9473684210526315,0.8809523809523809,10.319038301055972,16.014829705486612,20.386822112129533,10.985754222655567,13,46,38,42,5,12,5,9,80,54,55,55,8,34,33,33,7,0,7,3,2167
182,0.5,0.9166666666666666,0.9047619047619048,0.8846153846153846,0.8857142857142857,10.321776127407523,16.875135363903613,19.624029874028118,11.015178115876344,12,63,26,35,9,9,9,12,85,34,71,65,3,54,17,23,3,3,3,0,2168
183,0.5,0.7222222222222222,0.8863636363636364,0.9473684210526315,0.8620689655172413,10.368591789436017,16.043583096742793,20.01125767339439,11.165457962807176,18,44,38,29,8,8,8,7,78,52,58,66,10,36,30,22,4,4,4,5,2169
184,0.5,0.75,0.918918918918919,0.9130434782608695,0.9354838709677419,10.341411089082401,15.748335062922642,19.360477940269174,11.784044435566354,12,37,23,31,5,5,5,8,81,56,70,65,7,32,18,23,7,7,7,4,2170
185,0.5,0.5,0.8958333333333334,0.7878787878787878,0.8125,10.380909755702085,15.96523603554648,19.832832490830768,10.762833966289188,18,48,33,32,5,12,9,9,75,52,64,65,13,36,24,23,7,0,3,3,2171
186,0.5,0.8636363636363636,0.9574468085106383,0.8717948717948718,0.8620689655172413,10.448950582466349,16.070969426058518,20.192725821069114,10.813571718300029,22,47,39,29,8,7,12,8,74,48,61,67,14,40,27,21,4,5,0,4,2172
187,0.5,0.7333333333333333,0.9436619718309859,0.7894736842105263,0.85,10.291457857503541,17.058268959794976,18.94120301557006,11.083971606700963,15,71,19,20,8,12,12,8,81,29,81,76,7,59,7,12,4,0,0,4,2173
188,0.5,0.8,0.875,0.8695652173913043,1.0,10.201249152772249,15.775186250543513,18.559340688597683,11.024163254196441,5,40,23,25,5,7,9,0,88,55,74,63,0,33,14,25,7,5,3,12,2174
189,0.5,0.8333333333333334,0.8928571428571429,0.85,0.9230769230769231,10.45678125924175,16.467167941804167,20.444921575716375,11.130464377870672,24,56,40,65,9,9,9,9,73,41,57,32,15,47,31,56,3,3,3,3,2175
190,0.5,0.8095238095238095,0.9347826086956522,0.9696969696969697,1.0,10.451211850700712,16.120031743951067,20.165181004944646,11.463293491348244,21,46,33,26,12,12,9,9,79,54,64,71,9,34,24,17,0,0,3,3,2176
191,0.5,0.8461538461538461,0.9761904761904762,0.9130434782608695,1.0,10.287899927287743,15.856313619057735,19.324497198926124,11.13565114613899,13,42,23,27,5,5,5,5,80,51,70,66,8,37,18,22,7,7,7,7,2177
192,0.5,0.8235294117647058,0.7916666666666666,0.9090909090909091,1.0,10.406252380326363,16.15756458673538,19.33226877422085,11.437482056672346,17,48,22,36,9,5,9,9,80,45,75,61,8,43,13,27,3,7,3,3,2178
193,0.5,0.8461538461538461,0.8,0.8888888888888888,0.96,10.32447407333125,15.963271416447004,21.127213879113327,11.450567725451322,13,45,45,25,8,8,5,5,83,51,48,68,5,37,40,20,4,4,7,7,2179
194,0.5,0.875,0.9019607843137255,0.9375,0.9705882352941176,10.450630149731198,16.25120769926684,20.71205262187873,11.064099234199814,16,51,48,34,9,9,12,12,81,46,52,66,7,42,36,22,3,3,0,0,2180
195,0.5,0.84375,0.9384615384615385,0.9743589743589743,0.8888888888888888,10.602013477271514,16.98065328434798,20.5415239712161,11.368891992649209,32,65,39,45,9,12,4,9,65,35,53,52,23,53,35,36,3,0,8,3,2181
196,0.5,0.7142857142857143,0.9622641509433962,0.975609756097561,1.0,10.273440412308783,16.34814243027561,20.29613897468967,11.624445872252332,14,53,41,23,5,0,4,5,79,35,51,70,9,53,37,18,7,12,8,7,2182
197,0.5,0.8888888888888888,0.8717948717948718,0.9090909090909091,0.96,10.236548207629998,15.641572983352562,20.07336777782706,10.998572059420786,9,39,33,25,5,5,9,8,84,54,64,71,4,34,24,17,7,7,3,4,2183
198,0.5,0.9032258064516129,0.9074074074074074,0.8846153846153846,1.0,10.55520415033131,16.41294383069058,21.67862382325435,11.208070117618785,31,54,52,38,12,12,12,7,69,46,48,57,19,42,40,31,0,0,0,5,2184
199,0.5,0.7142857142857143,0.9,0.9285714285714286,0.7916666666666666,10.334107399791678,15.775882557437313,19.39764853082261,11.100542991817008,14,40,28,24,9,12,9,9,83,60,69,73,5,28,19,15,3,0,3,3,2185
200,1.5,0.7391304347826086,0.9375,0.8888888888888888,0.8,10.426885316342668,15.50985242621051,20.072689031665387,10.543218168841786,23,32,36,50,9,9,9,9,74,65,61,47,14,23,27,41,3,3,3,3,2186
201,1.5,1.0,0.9555555555555556,0.9512195121951219,0.9230769230769231,10.211774589097692,16.009553341736012,20.517393471933516,10.648546383029165,9,45,41,13,9,9,9,9,88,52,56,84,0,36,32,4,3,3,3,3,2187
202,1.5,0.8888888888888888,0.9,1.0,0.8846153846153846,10.459860691124469,15.879976360755546,20.2310184629488,11.262879678873599,18,40,41,26,12,12,9,5,82,60,56,67,6,28,32,21,0,0,3,7,2188
203,1.5,1.0,0.9545454545454546,0.9428571428571428,1.0,10.342894687133104,15.857945934001215,19.822007726809172,11.034305616676622,12,44,35,21,9,12,12,9,85,56,65,76,3,32,23,12,3,0,0,3,2189
204,1.5,0.8571428571428571,0.9444444444444444,0.9069767441860465,0.8333333333333334,10.357914381158677,16.32381850563622,20.80356563472358,11.387128662325047,14,54,43,18,9,12,12,9,83,46,57,79,5,42,31,9,3,0,0,3,2190
205,1.5,0.825,0.868421052631579,0.8857142857142857,0.8958333333333334,10.642064241485116,17.449751924733796,19.9258556559892,10.685080931258781,40,76,35,48,12,12,9,9,60,24,62,49,28,64,26,39,0,0,3,3,2191
206,1.5,0.8461538461538461,0.95,0.84,0.9117647058823529,10.48773792029295,15.829028998673465,21.236810901008567,10.915967861716501,26,40,50,34,12,12,12,12,74,60,50,66,14,28,38,22,0,0,0,0,2192
207,1.5,0.75,0.9104477611940298,0.9245283018867925,0.9347826086956522,10.552862498273043,16.823083651326,21.71427163478424,11.580268464505814,32,67,53,46,12,12,12,12,68,33,47,54,20,55,41,34,0,0,0,0,2193
208,1.5,0.8421052631578947,0.9666666666666667,0.84375,0.9722222222222222,10.401685068902845,16.587901930242175,19.68679981986663,11.048246057001593,19,60,32,36,9,12,12,12,78,40,68,64,10,48,20,24,3,0,0,0,2194
209,1.5,0.6666666666666666,0.925,0.8695652173913043,0.6666666666666666,10.386325176989462,15.799820477529305,19.13726126380972,10.955145959484572,9,40,23,15,5,9,9,5,84,57,74,78,4,31,14,10,7,3,3,7,2195
210,1.5,0.9090909090909091,0.8166666666666667,0.9272727272727272,0.9545454545454546,10.34921532019062,16.73500022638439,22.30023184761385,10.98704906154676,22,60,55,44,9,9,12,9,75,37,45,53,13,51,43,35,3,3,0,3,2196
211,1.5,0.6666666666666666,0.8,0.8974358974358975,0.8,10.365303009698824,15.485522465879239,20.84778792871446,10.540821303196655,12,25,39,15,12,12,12,12,88,75,61,85,0,13,27,3,0,0,0,0,2197
212,1.5,0.8235294117647058,0.9459459459459459,0.8235294117647058,0.9642857142857143,10.300153086791646,15.635278567315162,20.130413099657687,10.674825812393456,17,37,34,28,12,5,12,9,83,56,66,69,5,32,22,19,0,7,0,3,2198
213,1.5,0.8333333333333334,0.875,0.8918918918918919,0.8958333333333334,10.571049002197272,16.1825412686983,20.40187833648631,11.042340780864327,30,48,37,48,12,9,8,12,70,49,59,52,18,39,29,36,0,3,4,0,2199
214,1.5,0.7777777777777778,0.8771929824561403,0.9705882352941176,0.8181818181818182,10.15488803720116,16.456692718517452,19.974674787901428,10.791933002869559,9,57,34,22,9,9,9,9,88,40,63,75,0,48,25,13,3,3,3,3,2200
215,1.5,0.8333333333333334,0.8055555555555556,0.9047619047619048,0.9545454545454546,10.367230942367707,15.618745542661072,20.64673719513952,10.923903360809346,18,36,42,22,9,9,9,9,79,61,55,75,9,27,33,13,3,3,3,3,2201
216,1.5,1.0,0.9354838709677419,1.0,1.0,10.279935658416935,15.571612388853795,18.970921455129403,10.825992654569799,8,31,18,27,8,8,8,8,88,65,78,69,0,23,10,19,4,4,4,4,2202
217,1.5,0.7777777777777778,0.90625,0.8333333333333334,0.9230769230769231,10.337183515951972,15.600704585804305,19.3030856754698,10.609070142155336,9,32,24,13,9,12,9,9,88,68,73,84,0,20,15,4,3,0,3,3,2203
218,1.5,0.8,0.9571428571428572,0.9117647058823529,0.94,10.402516278633033,16.923547346435548,19.816537668835863,11.075366091983557,25,70,34,50,8,9,12,8,71,27,66,46,17,61,22,42,4,3,0,4,2204
219,1.5,0.625,0.9152542372881356,0.9,0.8648648648648649,10.389919933337074,16.640772283975515,20.050548456338756,11.282448795673766,16,59,30,37,9,5,9,9,81,34,67,60,7,54,21,28,3,7,3,3,2205
220,1.5,0.8571428571428571,0.9387755102040817,0.9090909090909091,0.9428571428571428,10.254101998911366,16.002160952067918,19.023297556060523,11.123988165323295,14,49,22,35,9,12,4,9,83,51,70,62,5,37,18,26,3,0,8,3,2206
221,1.5,0.8823529411764706,0.94,0.8947368421052632,0.8974358974358975,10.40588278352276,16.144020263064995,22.41216143244367,11.211919412862308,17,50,57,39,12,12,12,12,83,50,43,61,5,38,45,27,0,0,0,0,2207
222,1.5,0.6666666666666666,0.9117647058823529,1.0,0.9459459459459459,10.306554685278314,15.442540590763683,19.023459652869946,11.004138567665704,9,34,19,37,9,12,9,9,88,66,78,60,0,22,10,28,3,0,3,3,2208
223,1.5,0.7857142857142857,0.8723404255319149,0.7941176470588235,0.9130434782608695,10.3056504183768,15.848789498585042,19.801275408436567,10.842164000565093,14,47,34,23,9,12,9,9,83,53,63,74,5,35,25,14,3,0,3,3,2209
224,1.5,0.9166666666666666,0.90625,0.8823529411764706,0.9230769230769231,10.335671971311903,15.563461974229526,18.894016766840366,10.993340414291444,12,32,17,26,12,12,12,12,88,68,83,74,0,20,5,14,0,0,0,0,2210
225,1.5,0.7586206896551724,0.8518518518518519,0.9459459459459459,0.9629629629629629,10.445052431342065,16.373655833332254,19.95178876025458,11.087139161053427,29,54,37,27,9,12,12,9,68,46,63,70,20,42,25,18,3,0,0,3,2211
226,1.5,1.0,0.9512195121951219,0.9259259259259259,1.0,10.310759279050997,15.866776546472371,19.45096102820526,11.364214464051702,9,41,27,15,9,9,12,12,88,56,73,85,0,32,15,3,3,3,0,0,2212
227,1.5,0.8333333333333334,0.875,0.9411764705882353,0.9166666666666666,10.279865664238844,15.030324735816189,19.048189266152345,10.71650951934267,12,16,17,12,9,9,9,9,85,81,80,85,3,7,8,3,3,3,3,3,2213
228,1.5,0.7619047619047619,0.9423076923076923,0.8695652173913043,0.9032258064516129,10.416445802900496,16.249946509255917,20.77110328461073,10.734924623645409,21,52,46,31,9,5,9,12,76,41,51,69,12,47,37,19,3,7,3,0,2214
229,1.5,0.9166666666666666,0.926829268292683,0.9310344827586207,1.0,10.273372683691877,15.719439431540502,19.487176746013354,10.948426077449183,12,41,29,16,9,9,12,9,85,56,71,81,3,32,17,7,3,3,0,3,2215
230,1.5,0.7692307692307693,0.8611111111111112,0.8666666666666667,0.8936170212765957,10.269827886915198,15.577529019820917,22.186639534729622,11.582026716394104,13,36,60,47,5,5,9,8,80,57,37,49,8,31,51,39,7,7,3,4,2216
231,1.5,0.7878787878787878,0.8904109589041096,0.8846153846153846,0.8936170212765957,10.601321334610777,17.033382099218986,21.48368810479179,11.341435868485434,33,73,52,47,9,9,9,9,64,24,45,50,24,64,43,38,3,3,3,3,2217
232,1.5,0.7407407407407407,0.8703703703703703,0.7297297297297297,0.9032258064516129,10.498582151010801,16.467885632783663,20.201384763375476,11.25644760598856,27,54,37,31,12,12,9,12,73,46,60,69,15,42,28,19,0,0,3,0,2218
233,1.5,0.6470588235294118,0.9264705882352942,0.8333333333333334,0.8947368421052632,10.44921495324508,17.144771384057343,20.370863521618503,11.128336186657373,17,68,42,38,9,9,9,5,80,29,55,55,8,59,33,33,3,3,3,7,2219
234,1.5,1.0,0.8571428571428571,0.8918918918918919,0.9090909090909091,10.27682905103785,15.312150362130987,20.13254189963128,11.491183494560046,9,28,37,22,9,9,9,9,88,69,60,75,0,19,28,13,3,3,3,3,2220
235,1.5,0.65,0.890625,0.96875,0.8888888888888888,10.402099585018822,16.668546995638593,19.80630888324646,11.060047001172968,20,64,32,45,9,9,9,9,77,33,65,52,11,55,23,36,3,3,3,3,2221
236,1.5,0.8181818181818182,0.8536585365853658,0.9333333333333333,0.9714285714285714,10.430868980979268,15.558549714503755,20.642831917900292,11.501390157181723,22,41,45,35,9,5,12,12,75,52,55,65,13,36,33,23,3,7,0,0,2222
237,1.5,0.8148148148148148,0.8852459016393442,0.9285714285714286,0.9285714285714286,10.528645506543887,16.711792925971725,20.507125353791963,11.068796783754676,27,61,42,56,9,9,9,9,70,36,55,41,18,52,33,47,3,3,3,3,2223
238,1.5,0.8333333333333334,0.9016393442622951,0.8292682926829268,0.8823529411764706,10.210924231266576,16.715236755166277,20.56795186029813,11.124335677208531,12,61,41,51,9,12,9,12,85,39,56,49,3,49,32,39,3,0,3,0,2224
239,1.5,0.875,0.9215686274509803,0.9714285714285714,0.9318181818181818,10.310308292663635,16.204269783853544,19.99073357147499,10.848771794562545,16,51,35,44,12,12,12,8,84,49,65,52,4,39,23,36,0,0,0,4,2225
240,1.5,0.7647058823529411,0.8823529411764706,0.8571428571428571,0.8913043478260869,10.599272264428041,16.342048720424874,20.171393327795176,10.850559939995927,34,51,35,46,9,12,9,12,63,49,62,54,25,39,26,34,3,0,3,0,2226
241,1.5,0.9285714285714286,0.9242424242424242,0.9318181818181818,0.96,10.35149118657249,16.874628973128257,20.83125707484928,11.178181543548478,14,66,44,25,9,9,9,12,83,31,53,75,5,57,35,13,3,3,3,0,2227
242,1.5,0.6666666666666666,0.9245283018867925,0.782608695652174,0.9473684210526315,10.476494346813956,16.380011368705517,19.213105274075275,11.211515339234591,18,53,23,19,9,5,9,5,79,40,74,74,9,48,14,14,3,7,3,7,2228
243,1.5,0.7777777777777778,0.9180327868852459,0.8857142857142857,0.925,10.463327698614895,16.757822293821867,19.760045528033153,10.8060439658465,27,61,35,40,9,9,9,9,70,36,62,57,18,52,26,31,3,3,3,3,2229
244,1.5,0.75,0.8983050847457628,0.9024390243902439,0.88,10.318045173699865,16.14914454928263,20.653092672144897,10.928879580983512,16,59,41,25,8,12,12,9,80,41,59,72,8,47,29,16,4,0,0,3,2230
245,1.5,0.9047619047619048,1.0,0.975609756097561,0.9411764705882353,10.493292030256034,16.371615123502778,20.729399691198985,11.080482581156735,21,51,41,34,9,9,9,12,76,46,56,66,12,42,32,22,3,3,3,0,2231
246,1.5,0.7368421052631579,0.8888888888888888,0.875,0.9230769230769231,10.426896668899431,16.366559857381482,20.219503314137604,11.07812937906999,19,54,32,39,9,12,9,9,78,46,65,58,10,42,23,30,3,0,3,3,2232
247,1.5,0.7857142857142857,0.9047619047619048,0.95,0.9473684210526315,10.261471809152189,16.77661997836203,18.817514283224305,11.267391241467516,14,63,20,19,9,12,8,4,83,37,76,73,5,51,12,15,3,0,4,8,2233
248,1.5,0.8421052631578947,0.9032258064516129,0.9361702127659575,0.8955223880597015,10.373534415822656,16.567071241797965,21.122337379065346,11.161973373066038,19,62,47,67,9,9,12,12,78,35,53,33,10,53,35,55,3,3,0,0,2234
249,1.5,0.8333333333333334,1.0,0.9090909090909091,0.9545454545454546,10.370761199083232,16.354954975827212,18.86584351563765,11.133366953676854,18,54,22,22,9,9,9,9,79,43,75,75,9,45,13,13,3,3,3,3,2235
250,1.5,0.8214285714285714,0.8148148148148148,0.8913043478260869,0.8333333333333334,10.515048565406728,15.425920938480969,20.947742874333397,10.737276031072557,28,27,46,18,9,9,9,9,69,70,51,79,19,18,37,9,3,3,3,3,2236
251,1.5,0.8181818181818182,0.9069767441860465,0.9545454545454546,0.90625,10.458339112551132,16.076918258408032,19.4261193845057,10.744542655808766,22,43,22,32,12,12,12,12,78,57,78,68,10,31,10,20,0,0,0,0,2237
252,1.5,0.7727272727272727,0.8275862068965517,0.875,0.88,10.419092812024491,15.586436124029017,20.086475020589535,11.037094090632626,22,29,32,25,9,8,5,12,75,67,61,75,13,21,27,13,3,4,7,0,2238
253,1.5,0.9285714285714286,0.9038461538461539,0.8888888888888888,1.0,10.292222369147938,16.101638178475692,18.873544515996418,11.348839517576822,14,52,27,49,9,9,9,9,83,45,70,48,5,43,18,40,3,3,3,3,2239
254,1.5,0.7727272727272727,0.926829268292683,0.88,0.9523809523809523,10.353249428029036,15.591439687214407,20.770778041972907,11.1166325188839,22,41,50,21,12,12,12,12,78,59,50,79,10,29,38,9,0,0,0,0,2240
255,1.5,0.875,0.8958333333333334,0.9375,0.9615384615384616,10.331097387593573,16.220405781790493,18.649354972999824,11.21317935662742,16,48,16,26,9,12,9,9,81,52,81,71,7,36,7,17,3,0,3,3,2241
256,1.5,0.8076923076923077,0.9302325581395349,0.868421052631579,0.9545454545454546,10.50904824994463,15.977595112260234,20.420714677995385,10.947380576326934,26,43,38,44,9,9,9,9,71,54,59,53,17,34,29,35,3,3,3,3,2242
257,1.5,0.8888888888888888,0.8888888888888888,0.9166666666666666,0.9555555555555556,10.274014506198316,16.51507198411951,19.168569698467184,11.41848592816616,9,54,24,45,9,12,5,12,88,46,69,55,0,42,19,33,3,0,7,0,2243
258,1.5,1.0,0.8813559322033898,1.0,0.9761904761904762,10.384890273184604,16.49640704912806,19.32734766313881,11.008571119553247,12,59,24,42,9,9,9,9,85,38,73,55,3,50,15,33,3,3,3,3,2244
259,1.5,0.9473684210526315,0.9230769230769231,0.896551724137931,0.9069767441860465,10.408228014843285,16.52258270042159,19.911507503848846,10.859329029346775,19,52,29,43,9,9,9,9,78,45,68,54,10,43,20,34,3,3,3,3,2245
260,1.5,0.95,0.8923076923076924,0.8285714285714286,0.9375,10.399806168492642,16.870647991359846,20.432987492687406,11.264992191255242,20,65,35,16,12,12,12,8,80,35,65,80,8,53,23,8,0,0,0,4,2246
261,1.5,0.9166666666666666,0.8421052631578947,0.7666666666666667,0.9354838709677419,10.205245793506137,16.623780159683232,19.844484566359633,11.357581450613909,12,57,30,31,12,12,12,12,88,43,70,69,0,45,18,19,0,0,0,0,2247
262,1.5,0.8421052631578947,0.8333333333333334,0.8695652173913043,1.0,10.477278210144753,15.217281626158575,19.351109960804582,11.055313692440338,19,24,23,36,9,9,9,9,78,73,74,61,10,15,14,27,3,3,3,3,2248
263,1.5,0.9047619047619048,0.9154929577464789,0.9387755102040817,0.9444444444444444,10.437700245743391,17.097072105526042,21.468281351603324,10.446021479245756,21,71,49,18,9,9,9,9,76,26,48,79,12,62,40,9,3,3,3,3,2249
264,1.5,0.7857142857142857,0.825,0.875,0.9,10.349097174570677,15.693517704330725,19.57002790486841,10.723213440917894,14,40,24,40,9,12,9,9,83,60,73,57,5,28,15,31,3,0,3,3,2250
265,1.5,0.8571428571428571,0.9193548387096774,0.9230769230769231,0.9361702127659575,10.323781330403175,16.870596341108577,20.088814098700897,11.231994740352643,14,62,39,47,9,8,9,12,83,34,58,53,5,54,30,35,3,4,3,0,2251
266,1.5,1.0,0.9545454545454546,0.8947368421052632,0.9459459459459459,10.335660866210398,15.04134908718889,18.911235380030586,11.177974517207945,5,22,19,37,5,9,9,9,88,75,78,60,0,13,10,28,7,3,3,3,2252
267,1.5,0.85,0.875,0.8888888888888888,0.8235294117647058,10.442358425833588,15.801529977222458,19.48232661922297,11.169614466876723,20,40,27,34,9,9,9,9,77,57,70,63,11,31,18,25,3,3,3,3,2253
268,1.5,0.8461538461538461,0.8936170212765957,0.8888888888888888,0.8769230769230769,10.311963604210916,16.03429305550255,19.16564021533987,10.737719699379547,13,47,18,65,9,5,9,9,84,46,79,32,4,42,9,56,3,7,3,3,2254
269,1.5,0.8333333333333334,0.9310344827586207,1.0,0.8787878787878788,10.449394925431873,16.589771834306802,20.180215361597465,10.553083560753885,24,58,36,33,12,12,12,12,76,42,64,67,12,46,24,21,0,0,0,0,2255
270,1.5,0.8421052631578947,0.9074074074074074,0.9230769230769231,0.9210526315789473,10.340861895959662,16.29050572937392,20.134503437964053,10.922163468165007,19,54,39,38,9,9,9,9,78,43,58,59,10,45,30,29,3,3,3,3,2256
271,1.5,0.8888888888888888,0.8653846153846154,1.0,0.9024390243902439,10.2749166302958,16.345989838269777,20.000193148176944,11.248685495214717,9,52,34,41,5,5,5,9,84,41,59,56,4,47,29,32,7,7,7,3,2257
272,1.5,0.7586206896551724,0.7241379310344828,0.8809523809523809,0.8125,10.536983806295703,16.49493209111301,20.74114627541264,10.268014581139784,29,58,42,32,9,9,9,12,68,39,55,68,20,49,33,20,3,3,3,0,2258
273,1.5,0.8636363636363636,0.9010989010989011,0.7619047619047619,0.8823529411764706,10.50147773807546,18.26031294365064,20.624153640822914,10.992630320776438,22,91,42,51,9,12,9,9,75,9,55,46,13,79,33,42,3,0,3,3,2259
274,1.5,0.8235294117647058,0.9230769230769231,0.8571428571428571,0.8823529411764706,10.37497630815618,15.846572153133447,18.451846085401495,10.578488635751008,17,39,14,34,9,9,9,9,80,58,83,63,8,30,5,25,3,3,3,3,2260
275,1.5,0.7,0.8448275862068966,0.8837209302325582,0.8095238095238095,10.440555761591666,16.547184430920925,20.79391310133943,10.321121777073781,20,58,43,21,9,12,12,9,77,42,57,76,11,46,31,12,3,0,0,3,2261
276,1.5,0.8461538461538461,0.8955223880597015,0.7916666666666666,0.9117647058823529,10.346742881180992,16.868954244310466,19.65915947173119,10.366796369399857,13,67,24,34,9,9,9,9,84,30,73,63,4,58,15,25,3,3,3,3,2262
277,1.5,0.7727272727272727,0.9090909090909091,0.967741935483871,0.8888888888888888,10.38023653075472,15.933554996660002,19.45685337114018,11.176677944430624,22,44,31,27,9,12,12,9,75,56,69,70,13,32,19,18,3,0,0,3,2263
278,1.5,0.7407407407407407,0.9433962264150944,0.8367346938775511,0.9459459459459459,10.508085472422158,16.263995506738386,21.372985934327218,10.393165081569313,27,53,49,37,9,8,12,9,70,43,51,60,18,45,37,28,3,4,0,3,2264
279,1.5,0.85,0.8846153846153846,0.8421052631578947,0.8918918918918919,10.375871771911182,16.282262909187118,20.12080818726464,10.869846231375657,20,52,38,37,9,12,9,9,77,48,59,60,11,40,29,28,3,0,3,3,2265
280,1.5,0.7777777777777778,0.8571428571428571,0.8947368421052632,0.9565217391304348,10.279490743330022,15.364874506045146,18.926884318824023,10.795682900046392,9,28,19,23,9,9,9,9,88,69,78,74,0,19,10,14,3,3,3,3,2266
281,1.5,0.9230769230769231,0.96,0.8461538461538461,0.9090909090909091,10.389089546238871,15.134228034776134,18.440720060079194,10.977791662589027,13,25,13,33,9,9,5,9,84,72,80,64,4,16,8,24,3,3,7,3,2267
282,1.5,0.9090909090909091,0.9090909090909091,0.8461538461538461,0.9117647058823529,10.543894649404967,16.397519245330813,18.593841445477857,11.287322152331285,33,55,13,68,9,9,9,9,64,42,84,29,24,46,4,59,3,3,3,3,2268
283,1.5,1.0,0.9166666666666666,1.0,1.0,10.375057297834843,15.510532604376648,19.262504641028645,11.146495848330229,9,36,27,13,9,9,5,9,88,61,66,84,0,27,22,4,3,3,7,3,2269
284,1.5,0.8636363636363636,0.875,0.96,0.9714285714285714,10.447276758722774,15.600311800589111,19.177451976325973,10.913002821868282,22,32,25,35,12,12,12,12,78,68,75,65,10,20,13,23,0,0,0,0,2270
285,1.5,0.8888888888888888,0.8979591836734694,0.8709677419354839,0.9047619047619048,10.319540614190005,16.35214109108514,19.97958873153398,12.030614618620975,9,49,31,21,9,9,9,9,88,48,66,76,0,40,22,12,3,3,3,3,2271
286,1.5,0.8823529411764706,0.8723404255319149,0.9032258064516129,0.9038461538461539,10.309719136984729,16.049888469836343,19.576005047370636,10.90337149936558,17,47,31,52,12,12,12,12,83,53,69,48,5,35,19,40,0,0,0,0,2272
287,1.5,0.75,1.0,0.9354838709677419,0.9090909090909091,10.206163112688708,15.586528198892758,19.33095099847296,10.89712993021066,8,37,31,33,5,12,8,5,85,63,65,60,3,25,23,28,7,0,4,7,2273
288,1.5,0.8823529411764706,0.9210526315789473,0.975609756097561,0.9090909090909091,10.336315500849798,16.0189440925636,20.70684477406501,10.78038875486301,17,38,41,22,12,9,12,12,83,59,59,78,5,29,29,10,0,3,0,0,2274
289,1.5,0.8,0.9347826086956522,0.8888888888888888,0.85,10.409237129762488,16.030163929317307,19.073520377507005,10.664570079044077,15,46,18,20,5,5,8,5,78,47,78,73,10,41,10,15,7,7,4,7,2275
290,1.5,0.9090909090909091,0.9787234042553191,0.9444444444444444,0.9285714285714286,10.419686417713114,15.914339576260405,20.050851020477683,11.151678905619688,22,47,36,42,12,12,12,12,78,53,64,58,10,35,24,30,0,0,0,0,2276
291,1.5,0.8947368421052632,0.8983050847457628,0.918918918918919,0.975609756097561,10.36894068726524,16.557435297910036,19.708588390065085,10.923856953888405,19,59,37,41,9,9,12,9,78,38,63,56,10,50,25,32,3,3,0,3,2277
292,1.5,0.8181818181818182,0.85,0.9411764705882353,0.9487179487179487,10.388115798698317,16.142373339197253,20.06975175983515,11.05135985196708,11,40,34,39,8,8,12,8,85,56,66,57,3,32,22,31,4,4,0,4,2278
293,1.5,0.7857142857142857,0.9259259259259259,0.8333333333333334,0.8787878787878788,10.33743489486242,16.150413057954715,21.218124513411365,10.925740710334592,14,54,48,33,9,12,9,9,83,46,49,64,5,42,39,24,3,0,3,3,2279
294,1.5,0.7777777777777778,0.8833333333333333,0.9512195121951219,0.96875,10.42341832214798,16.423040408595924,21.064969218402673,11.212292823436478,9,60,41,32,9,5,9,9,88,33,56,65,0,55,32,23,3,7,3,3,2280
295,1.5,0.8,0.8,0.8125,0.9,10.373234558062867,16.383655528968735,19.894367204920684,11.299814750696672,20,55,32,30,9,9,9,12,77,42,65,70,11,46,23,18,3,3,3,0,2281
296,1.5,0.6875,0.847457627118644,0.8695652173913043,0.896551724137931,10.357893491650524,16.713818541591106,20.806390646671414,11.322930713118541,16,59,46,29,12,12,12,12,84,41,54,71,4,47,34,17,0,0,0,0,2282
297,1.5,0.7878787878787878,0.9137931034482759,0.9,0.9285714285714286,10.589784522200155,16.537497921175905,19.90850528280174,10.844736798978426,33,58,30,42,9,5,8,9,64,35,66,55,24,53,22,33,3,7,4,3,2283
298,1.5,0.8947368421052632,0.8260869565217391,0.8620689655172413,0.975609756097561,10.417807019296527,16.19126954937884,19.556517531663346,11.174708319408836,19,46,29,41,9,9,9,12,78,51,68,59,10,37,20,29,3,3,3,0,2284
299,1.5,0.8461538461538461,0.9285714285714286,0.9166666666666666,1.0,10.367365937121273,16.46584155861634,19.238259201139147,10.317697472267538,13,56,24,29,9,5,9,5,84,37,73,64,4,51,15,24,3,7,3,7,2285
